Ca-Ogg Vorbis-article.ogg	Gravació de l'article Ogg Vorbis de la Viquipèdia en català.	PD-self
Ca-TV3-article.ogg	Gravació de l'article TV3 de la Viquipèdia en català.	GFDL
Lad Cuig - Mira al teu Voltant.ogg	Lád Cúig. Mira al teu Voltant	cc-by-sa-3.0
LES FLORS DE MAIG.ogg	cant coral de Josep A.Clavé	cc-by-sa-3.0
LS FLORS DE MAIG.ogg	peça coral del Josep A. Clavé	cc-by-sa-3.0
76 Pista 76 converted.ogg	Cant d'ocells i nom llatí del mateix	cc-by-sa-3.0
Cigne petit.ogg	Cigne petit, en llatí (Cygnus columbianus)	cc-by-sa-3.0
Oca de bec curt.ogg	Nom de l'Oca de bec curt en llatí (Anser brachyrhynchus)	cc-by-sa-3.0
Oca Vulgar.ogg	El nom de l'Oca vulgar en llatí és (Anser anser)	cc-by-sa-3.0
Branta bernicla.ogg	Oca de collar en llatí (Branta bernicla)	cc-by-sa-3.0
Corriol gros 5.ogg	Corriol gros en llatí (Charadrius hiaticula)	cc-by-sa-3.0
Composició.ogg	Primera composició de Joan Rovira	cc-by-sa-3.0
Modus Operandi.ogg	Una cançó d'un dels meus grups preferits. Sublime!!!	cc-by-sa-3.0
Entrevista a Montserrat Carulla i Ventura RTVC 1982.ogg	Entrevista a Montserrat Carulla realitzada per Ràdio Televisió de Cardedeu	Youtube
Veïns Algemesí contra canvi nom avinguda.ogg	Debat sobre el canvi de nom a l'Avinguda del País Valencià d'Algemesí	cc-by-sa-3.0
PamEnTuPais.ogg	Versió de Lefazo en tu Bazo sobre l'enemistat entre Pam i Maria Gelabert	cc-by-sa-3.0
SerenataGranados.ogg	Partitura inèdita d'Enric Granados dedicata a Issac Albèniz. Font: Museu d'Art de Girona	PD-Art|PD-old-100
Stokos4, mostra de so.ogg	Mostra de so amb el sintetitzador electrònica de música aleatòria Stokos 4	cc-by-sa-3.0
Pensem-nos 5 - Entrevista Tempir.ogg	Entrevista al president de l'Associació Cívica per la Llengua El Tempir, d'Elx.	cc-by-sa-3.0
Pensem-nos 4 - Entrevista Juan Ignacio Blanco.ogg	Entrevista al periodista i criminòleg Juan Ignacio Blanco	cc-by-sa-3.0
Kalebarraka - 28 05 2014 - Entrevista Jordi Sebastià.ogg	Programa del 28 de maig de 2014, amb entrevista post-electoral a Jordi Sebastià, de Compromís.	cc-by-sa-4.0
Pensem-nos 8 - Entrevista Víctor Baeta.ogg	Entrevista a Víctor Baeta.	cc-by-sa-3.0
Campanes sitges 01.ogg	Son des cloches de l'église de Sant Bartomeu et Santa Tecla Sitges	cc-zero
Grallers Sitges.ogg	So de les gralles als carrers de Sitges (Escola de Grallers de Sitges)	cc-by-sa-3.0
Ca-Relació Transitiva-article.ogg	Voice recording of the Catalan article https://ca.wikipedia.org/wiki/Relació_transitiva	cc-by-sa-4.0
Unió Catalana de federacions.ogg	Presentació d'un programa radiofònic setmanal dedicat a l'esport català	cc-by-sa-4.0
Pensem-nos 10 - Entrevista a Vicent Baydal.ogg	Entrevista a l'Historiador Vicent Baydal i Sala	cc-by-sa-4.0
Pensem-nos 9 - Entrevista Félix Rodrigo.ogg	Entrevista a Félix Rodrigo Mora	cc-by-sa-4.0
Entrevista a Josep Lluís Bausset 2010.ogg	Entrevista realitzada pel portal Valencianisme.com (a partir del minut 7.14 pregunta Juli Esteve) al valencianista Josep Lluís Bausset	cc-by-sa-4.0
Pensem-nos 11 - Entrevista a Lluís Fornés.ogg	Programa 11 de Pensem-nos, amb una entrevista a Lluís Fornés	cc-by-sa-4.0
Mary Nash- ca.ogg	Mary Nash- spoken voice for the Voice into project	cc-by-sa-4.0
Cant de la Senyera.ogg	Gravació sonora d'''El Cant de la Senyera'' de Lluís Millet, interpretada per l'Orfeó Català, entre el 1898-1918. La còpia pertany al Fons de cilindres sonors de la Biblioteca de Catalunya	PD-old
La mort del Sifoner i la Llista Fabregat.ogg	Tall del programa de ràdio on Lluís Fornés explica "la mort del Sifoner" arran del tractament que en premsa es va donar a la "llista Fabregat".	cc-by-sa-4.0
10 Cal Calissó - Intro - Arús.ogg	Passejant amb Joan Arús.	cc-by-sa-4.0
13 Tota la vida se me'n va en cançons - Arús.ogg	Passejant amb Joan Arús.	cc-by-sa-4.0
18 El Brunet - Intro - Arús.ogg	Passejant amb Joan Arús.	cc-by-sa-4.0
24 Camí de la Malesa - Intro - Arús.ogg	Passejant amb Joan Arús.	cc-by-sa-4.0
01 Davant casa seva - Intro - Arús.ogg	Passejant amb Joan Arús.	cc-by-sa-4.0
30 Camí de la Malesa - Ssss - Arús.ogg	Passejant amb Joan Arús.	cc-by-sa-4.0
32 Dalt del turó de la Malesa - Intro - Arús.ogg	Passejant amb Joan Arús.	cc-by-sa-4.0
37 La Malesa - Intro - Arús.ogg	Passejant amb Joan Arús.	cc-by-sa-4.0
43 El gorg - Intro - Arús.ogg	Passejant amb Joan Arús.	cc-by-sa-4.0
49 El riu - Intro - Arús.ogg	Passejant amb Joan Arús.	cc-by-sa-4.0
38 Poema del caçador - Arús.ogg	Passejant amb Joan Arús.	cc-by-sa-4.0
56 La casa pairal - Intro - Arús.ogg	Passejant amb Joan Arús.	cc-by-sa-4.0
67 La comunió - Arús.ogg	Passejant amb Joan Arús.	cc-by-sa-4.0
50 Caçant - Arús.ogg	Passejant amb Joan Arús.	cc-by-sa-4.0
Joan Vila sobre en Ramon Barnils.ogg	Citació d'en Joan Vila sobre en Ramon Barnils	cc-by-sa-4.0
Joan Vila.ogg	Nota de veu d'en Joan Vila.	cc-by-sa-4.0
David Bassa (veu).ogg	Nota de veu d'en Joan Bassa.	cc-by-sa-4.0
Fèlix Riera (veu).ogg	Nota de veu d'en Fèlix Riera.	cc-by-sa-4.0
Sílvia Cóppulo (veu).ogg	Nota de veu de Sílvia Cóppulo.	cc-by-sa-4.0
Ramon Solsona (veu).ogg	Nota de veu d'en Ramon Solsona.	cc-by-sa-4.0
Xavier Bertran (veu).ogg	Nota de veu d'en Xavier Bertran.	cc-by-sa-4.0
Ton Barnils (veu).ogg	Nota de veu d'en Ton Barnils, fill d'en Ramon Barnils.	cc-by-sa-4.0
Xavier Graset (veu).ogg	Nota de veu d'en Xavier Graset.	cc-by-sa-4.0
Saül Gordillo - veu.ogg	Veu lliure de Saül Gordillo	cc-by-sa-4.0
02 Així és mon esperit.ogg	Poesia de Joan Arús	cc-by-sa-4.0
40 Equivoc fresseig.ogg	Poesia de Joan Arús	cc-by-sa-4.0
27 Petjades.ogg	Poesia de Joan Arús	cc-by-sa-4.0
51 Cap al bosc.ogg	Poesia de Joan Arús	cc-by-sa-4.0
57 La casa pairal.ogg	Poesia de Joan Arús	cc-by-sa-4.0
68 Autoal·legoria.ogg	Poesia de Joan Arús	cc-by-sa-4.0
Francesc Grau - veu.ogg	Veu de'n Francesc Grau	cc-by-sa-4.0
VX - Krakatoa (Sense Pietat 2013).ogg	Cançó "Krakatoa" de la Demo (tercer treball) d'VX, "Sense Pietat".	cc-by-sa-3.0
VX - Sense Pietat (Sense Pietat 2013).ogg	Cançó "Sense Pietat" de la Demo (tercer treball) d'VX, "Sense Pietat".	cc-by-sa-3.0
Pérotin - sederunt principes.ogg	compassos 107 al 116 del sederunt principes de Pérotin	cc-by-sa-4.0
Beata virgine Des Prez.ogg	Beata virgine Des Prez	cc-by-sa-4.0
La Represa - Ràdio Godella - 9-10-2015.ogg	Programa pilot de la represa. Entrevista a Vicent Baydal	cc-by-sa-4.0
Vicent Baydal i Sala - voice.ogg	Mostra de veu de Vicent Baydal	cc-by-sa-4.0
La Represa - Ràdio Godella - 16-10-2015.ogg	Segon programa de la represa. Entrevista a Amadeu Mezquida	cc-by-sa-4.0
Kalebarraka - 09 07 2014 - Entrevista Mònica Oltra.ogg	Programa del 9 de juliol de 2014, amb entrevista a Mònica Oltra, de Compromís.	cc-by-sa-4.0
Kalebarraka - 19 11 2014 - Entrevista Josep Nadal.ogg	Programa del 19 de novembre de 2014, amb entrevista pre-electoral a Josep Nadal, contant de la Gossa Sorda i candidat de Compromís.	cc-by-sa-4.0
Kalebarraka - 22 10 2014 - Entrevista Eugeni Alemany.ogg	Programa del 22 d'octubre de 2014, amb Eugeni Alemany.	cc-by-sa-4.0
Kalebarraka - 10 12 2014 - Entrevista Miquel Gil.ogg	Entrevista al cantant Miquel Gil.	cc-by-sa-4.0
Toni de l'Hostal - voice.ogg	Mostra de veu de Toni de l'Hostal	cc-by-sa-4.0
Tio Pep - Toni de l'Hostal.ogg	Interpretació de Toni de l'Hostal de la cançó popular "El Tio Pep". Versió country.	cc-by-sa-4.0
La Represa - Ràdio Godella - 23-10-2015.ogg	Tercer programa de la represa. Entrevista a Toni de l'Hostal	cc-by-sa-4.0
Vicent Chilet - voice.ogg	Mostra de veu de l'escriptor i periodista Vicent Chilet	cc-by-sa-4.0
La Represa - Ràdio Godella - 13-11-2015.ogg	Entrevista a Quico Soro	cc-by-sa-4.0
Quico Soro - voice.ogg	Mostra de veu del pilotaire Francesc Soro	cc-by-sa-4.0
La Represa - Ràdio Godella - 06-11-2015.ogg	Entrevista a Vicent Chilet	cc-by-sa-4.0
Contrapunt dissonant.ogg	Contrapunt dissonant	cc-by-sa-4.0
Kalebarraka - 28 10 2015 - Entrevista Ignacio Blanco.ogg	Programa del 28 d'octubre de 2015, amb entrevista a Ignacio Blanco.	cc-by-sa-4.0
Agustí Cerdà - voice.ogg	Seté programa de la represa. Entrevista a Agustí Cerdà.	cc-by-sa-4.0
La Represa - Ràdio Godella - 20-11-2015.ogg	Seté programa de la represa. Entrevista a Agustí Cerdà.	cc-by-sa-4.0
Josep Lluís Albinyana - voice.ogg	Mostra de veu de Josep Lluís Albinyana	cc-by-sa-4.0
La Represa - Ràdio Godella - 27-11-15.ogg	Huitena i desena entrevista de La Represa. Programa complet. Entrevista a Josep LLuís Albinyana	cc-by-sa 4.0
La Represa - Ràdio Godella - 19-12-15.ogg	Onzena entrevista de La Represa. Entrevista a Ferran Martínez	cc-by-sa-4.0
Carles Solà i Ferrando (veu).ogg	Nota de veu d'en Carles Solà Ferrando.	cc-by-sa-4.0
La Represa - Ràdio Godella - 08-01-2016.ogg	Entrevista amb Antoni Laguna	cc-by-sa-4.0
Eugeni Alemany - voice.ogg	Mostra de veu a l'artista, guionista i "comboiante" Eugeni Alemany	cc-by-sa-4.0
La Represa - Ràdio Godella - 05-02-2016.ogg	Entrevista a Andrés Boix Palop, jurista i fundador de La Página Definitiva	cc-by-sa-4.0
La Represa - Ràdio Godella - 12-02-2016.ogg	Entrevista al pedagog Josep Chaqués, fundador d'Escola Valenciana	cc-by-sa-4.0
La Represa - Ràdio Godella - 4-03-2016.ogg	Entrevista a Francesc Ferrandis, ideòleg del PVN	cc-by-sa-4.0
La Represa - Ràdio Godella - 26-02-2016.ogg	Entrevista amb Pepe Martínez Tormo	cc-by-sa-4.0
La Represa - Ràdio Godella - 18-03-2016.ogg	Entrevista amb Abelard Saragossà	cc-by-sa-3.0
La Represa - Ràdio Godella - 15-01-2016.ogg	Entrevista a Vicent Flor	cc-by-sa-3.0
Josep Almudéver - voice.ogg	Mostra de veu de Josep Almudéver Mateu (''né'' Joseph Eduard Almudever).	cc-by-sa-4.0
Marta Sorlí - voice.ogg	Autopresentació de Marta Sorlí	cc-by-sa-4.0
La Represa - Ràdio Godella - 29-04-2016.ogg	Entrevista amb Marta Sorlí de La Represa, emesa el 29 d'abril de 2016	cc-by-sa-4.0
Josep Chaqués - voice.ogg	Autopresentació de Josep Chaqués a La Represa	cc-by-sa-4.0
La Represa - Ràdio Godella - 22-04-2016.ogg	Entrevista amb Miquel Nadal i Tàrrega en motiu del dia del llibre i la publicació del seu llibre "inventari mínim".	cc-by-sa-4.0
Miquel Nadal - voice.ogg	Entrevista amb Miquel Nadal i Tàrrega en motiu del dia del llibre i la publicació del seu llibre "inventari mínim".	cc-by-sa-4.0
La Represa - Ràdio Godella - 13-05-2016.ogg	Entrevista amb Josep Almudéver, veterà de la Guerra Civil Espanyola, i amb Toni Simó, historiador d'Alcàsser especialitzat en la seua figura.	cc-by-sa-4.0
Abelard Saragossà - voice.ogg	Mostra de veu d'Abelard Saragossà	cc-by-sa-4.0
Toni Mollà - Llista Fabregat.ogg	Entrevista a Toni Mollà, La Represa. Parla sobre la realització de la "Llista Fabregat".	cc-by-sa-4.0
La Represa - Ràdio Godella - 20-05-2016.ogg	Entrevista a Toni Mollà, La Represa	cc-by-sa-4.0
La Represa - Ràdio Godella - 01-07-2016.ogg	Entrevista amb Joan Josep Senent i Moreno.	CC-BY-SA 4.0
Manolo Mata - voice.ogg	Audio-presentació de Manolo Mata.	CC-BY-SA 4.0
La Represa - Ràdio Godella - 10-06-2016.ogg	Entrevista amb Manolo Mata.	CC-BY-SA 4.0
La Represa - Ràdio Godella - 17-06-2016.ogg	Entrevista amb Carlos Villodres	CC-BY-SA 4.0
La Represa - Ràdio Godella - 24-06-2016.ogg	Entrevista amb Yuri Aguilar.	CC-BY-SA 4.0
La Represa - Ràdio Godella - 03-06-2016.ogg	Entrevista a Josep Puchades	CC-BY-SA 4.0
La Represa - Ràdio Godella - 27-05-2016.ogg	Entrevista a Àgueda Micó	CC-BY-SA 4.0
Vicent Flor - voice.ogg	Mostra de veu de Vicent Flor i Moreno	CC-BY-SA 4.0
Son Goku - catalan (valencian dubbing) voice.ogg	Mostra de veu de Mari Carme Giner interpretant la veu de Son Goku (xiquet) a Bola de Drac, una de les sèries de televisió que va doblar.	CC-BY-SA 4.0
Voice - ca - Geni Tortuga (Francesc Fenollosa).ogg	Mostra de veu de Francesc Fenollosa fent de Geni Tortuga, un dels personatges que ha doblat	CC-BY-SA 4.0
Voice - ca - Rafa Contreras (Woody Allen, Annie Hall).ogg	L'actor de doblatge Rafa Contreras actuant com Woody Allen a la pel·lícula Annie Hall	CC-BY-SA 4.0
Toni de l'Hostal parla de La Cabota.ogg	Toni de l'Hostal parla sobre la publicació satírica "La Cabota"	cc-by-sa-4.0
El paller.ogg	Versió sonora interpretada per Òscar Rocabert.	cc-by-sa-4.0
Els poetes.ogg	Versió sonora interpretada per Òscar Rocabert.	cc-by-sa-4.0
07 La rima.ogg	Versió sonora interpretada per Rosa Baró.	cc-by-sa-4.0
65 La nit al mas.ogg	Versió sonora interpretada per Rosa Baró	cc-by-sa-4.0
17 Tarda d'abril.ogg	Versió sonora interpretada per Rosa Baró.	cc-by-sa-4.0
41 El rierol.ogg	Versió sonora interpretada per Rosa Baró.	cc-by-sa-4.0
21 Quin esclat de colors.ogg	Versió sonora interpretada per Rosa Baró.	cc-by-sa-4.0
26 Com un núvol.ogg	Versió sonora interpretada per Rosa Baró.	cc-by-sa-4.0
52 El repòs.ogg	Versió sonora interpretada per Rosa Baró.	cc-by-sa-4.0
61 Tarda de maig al camp.ogg	Versió sonora interpretada per Rosa Baró.	cc-by-sa-4.0
25 4 camins.ogg	Versió sonora interpretada per Margarida Gubern.	cc-by-sa-4.0
58 El predi.ogg	Versió sonora interpretada per Margarida Gubern.	cc-by-sa-4.0
4 Inspiració.ogg	Versió sonora interpretada per Margarida Gubern.	cc-by-sa-4.0
34 El mar enllà.ogg	Versió sonora interpretada per Margarida Gubern.	cc-by-sa-4.0
44 Els gorgs.ogg	Versió sonora d'un poema de Joan Arús interpretada per Margarida Gubern.	cc-by-sa-4.0
53 Riu.ogg	Versió sonora d'un poema de Joan Arús interpretada per Margarida Gubern.	cc-by-sa-4.0
66 Oració.ogg	Versió sonora d'un poema de Joan Arús interpretada per Margarida Gubern.	cc-by-sa-4.0
62 La llar.ogg	Versió sonora d'un poema de Joan Arús	cc-by-sa-4.0
08 Els versos.ogg	Versió sonora d'un poema de Joan Arús	cc-by-sa-4.0
14 Núvol rosa.ogg	Versió sonora d'un poema de Joan Arús	cc-by-sa-4.0
55 La verneda.ogg	Versió sonora d'un poema de Joan Arús	cc-by-sa-4.0
45 Jo sóc talment.ogg	Versió sonora d'un poema de Joan Arús	cc-by-sa-4.0
16 Ai la paraula.ogg	Versió sonora d'un poema de Joan Arús	cc-by-sa-4.0
63 Aquella mà.ogg	Versió sonora d'un poema de Joan Arús	cc-by-sa-4.0
05 La paraula.ogg	Versió sonora d'un poema de Joan Arús	cc-by-sa-4.0
19 Absències.ogg	Versió sonora d'un poema de Joan Arús	cc-by-sa-4.0
22 La font.ogg	Versió sonora d'un poema de Joan Arús	cc-by-sa-4.0
42 Torrent florit.ogg	Versió sonora d'un poema de Joan Arús	cc-by-sa-4.0
35 El te de roca.ogg	Versió sonora d'un poema de Joan Arús	cc-by-sa-4.0
59 El meu pi.ogg	Versió sonora d'un poema de Joan Arús	cc-by-sa-4.0
06 Ritme.ogg	Versió sonora d'un poema de Joan Arús	cc-by-sa-4.0
12 Cançoneta.ogg	Versió sonora d'un poema de Joan Arús	cc-by-sa-4.0
36 Elegia forestal.ogg	Versió sonora d'un poema de Joan Arús	cc-by-sa-4.0
20 Retorn absències.ogg	Versió sonora d'un poema de Joan Arús	cc-by-sa-4.0
33 Racó de món.ogg	Versió sonora d'un poema de Joan Arús	cc-by-sa-4.0
09 Els mestres.ogg	Versió sonora d'un poema de Joan Arús i Colomer.	cc-by-sa-4.0
11 Per l'inescrutable.ogg	Versió sonora d'un poema de Joan Arús i Colomer.	cc-by-sa-4.0
48 Drecera.ogg	Versió sonora d'un poema de Joan Arús	cc-by-sa-4.0
23 Poesia.ogg	Versió sonora d'un poema de Joan Arús i Colomer.	cc-by-sa-4.0
46 Canyar.ogg	Versió sonora d'un poema de Joan Arús i Colomer.	cc-by-sa-4.0
64 Germana.ogg	Versió sonora d'un poema de Joan Arús i Colomer.	cc-by-sa-4.0
31 Ja les veremes.ogg	Versió sonora d'un poema de Joan Arús i Colomer.	cc-by-sa-4.0
15 Veig una noia.ogg	Versió sonora d'un poema de Joan Arús i Colomer.	cc-by-sa-4.0
El meu poble-2.ogg	Versió sonora d'un poema de Joan Arús	cc-by-sa-4.0
Vicent Baydal - voice 01.ogg	Autopresentació de Vicent Baydal	CC-BY-SA 4.0
Jose Ignacio Casar Pinazo - voice.ogg	Autopresentació de Jose Ignacio Casar Pinazo	CC-BY-SA 4.0
Gervasio Sánchez - voice.ogg	Autopresentació de Gervasio Sánchez	CC-BY-SA 4.0}}{{Museu Valencià d'Etnologia
La Represa - Ràdio Godella - 09-09-2016.ogg	Entrevista a Gervasio Sánchez	CC-BY-SA 4.0}}{{Museu Valencià d'Etnologia
La Represa - Ràdio Godella - 16-09-2016.ogg	Vicent Baydal i J. Ignacio Casar Pinazo parlen sobre Ignasi Pinazo Camarlench	CC-BY-SA 4.0
Viquitrobada 2016 - jazz.ogg	Anunci de la Viquitrobada 2016. Música: Turning Points.	cc-by-sa 3.0
Viquitrobada 2016 - smiling.ogg	Anunci de la Viquitrobada 2016. Música: [[:File:HeComesUpSmiling.ogg|He Comes Up Smiling]].	cc-by-sa 3.0
Viquitrobada 2016 - samba.ogg	Anunci de la Viquitrobada 2016. Música: Samba de fato.	cc-by-sa 3.0
XXX Individual - Colp a Colp 29.ogg	Crònica de la fase prèvia del XXX Individual de Raspall<br />Basat en [http://www.pilotaveu.com/article/12143/pablo-guanya-a-guadassuar-i-la-llosa-de-ranes-tancara-la-ronda-previa-als-quarts-de-final crònica de PilotaVeu]	CC-BY-SA 4.0
Moltó i Sergio - Colp a Colp 32.ogg	Testimoni dels dos finalistes previ a la final del XXX Individual de Raspall	CC-BY-SA 4.0
Entrevista Marrahí - Colp a Colp 32.ogg	El campió de l'Individual de Raspall 2014, Marrahí, analitza la final de 2016 per a Colp a Colp	CC-BY-SA 4.0
Entrevista Marc de Montserrat - Colp a Colp 17.ogg	Entrevista a Marc de Montserrat analitzant el seu debut a la Copa Diputació de València	CC-BY-SA 4.0
Entrevista Punxa - Colp a Colp 22.ogg	Entrevista a Àngel Gregori Roig, ''Punxa'', de cara a la final de la Copa de Raspall 2016.	CC-BY-SA 4.0
Entrevista Sacha - Colp a Colp 25.ogg	Entrevista a Sacha Kruithof Perelló, pilotari en modalitat de Llargues i a estil indirecte, abans de la seua participació al Mundial de One Wall a Las Vegas	CC-BY-SA 4.0
Entrevista Soro III - Colp a Colp 28.ogg	Entrevista a Soro III, campió de l'individual en 2015, abans del començament de l'edició de 2016.	CC-BY-SA 4.0
La Represa - Ràdio Godella - 21-10-2016.ogg	Entrevista amb Josep Nadal, vocalusta i fundador de La Gossa Sorda	CC-BY-SA 4.0
Oració de Sant Roro (Barxeta).ogg	Oració de Sant Roro	PermissionTicket|id=2016111410011367|user=Ruthven
Nadala - Vallés (Fermín Pardo).ogg	Nadala enregistrada a Vallés (La Costera).	CC-BY-SA 4.0
Aguinaldo - Vallés (Fermín Pardo).ogg	Cançó d'Aguinaldo enregistrada a Vallés (La Costera).	CC-BY-SA 4.0
Amàlia Garrigós - voice.ogg	Autopresentació (curta) d'Amàlia Garrigós, realitzada a la seua entrevista a La Represa	cc-by-sa-4.0
Amàlia Garrigós - voice (llarg).ogg	Autopresentació (llarga) d'Amàlia Garrigós, realitzada a la seua entrevista a La Represa	cc-by-sa-4.0
La Represa - Ràdio Godella - 16-12-2016.ogg	Entrevista a Amàlia Garrigós a 'La Represa' (Ràdio Godella, Xarxa d'Emissores Municipals Valencianes) estrenada el 12 de desembre de 2016	cc-by-sa-4.0
Individual 2016 i entrevista a Grau.ogg	Crònica de la segona partida de semifinals del XXXI Individual i entrevista a Grau, realitzada al programa n. 31 de Colp a Colp.	CC-BY-SA 4.0
Aritz Lasa a Colp a Colp (gener 2017).ogg	Entrevista amb Aritz Lasa després de la partida celebrada al Puig contra Adrián de Quart.	CC-BY-SA 4.0
Joan Baldoví - voice.ogg	Mostra de veu de Joan Baldoví	cc-by-sa-4.0
5-4 dictat ok.ogg	dictat musical	cc-by-sa-4.0
(KARAOKE) - DÉJATE LLEVAR - iLeoVlogs y DalasReview.ogg	Cançó "Déjate llevar" dels youtubers iLeoVlogs i DalasReview, versió karaoke.	LicenseReview|site=[https://www.youtube.com/watch?v=v3uDBefpKjQ <nowiki>[KARAOKE]</nowiki> - DÉJATE LLEVAR - iLeoVlogs y DalasReview]|user=Daphne Lantier|date=2017-03-11
Rosa Solbes - voice.ogg	Presentació de Rosa Solbes al 63 programa de La Represa	cc-by-sa-4.0
Àgueda Micó - voice.ogg	Autopresentació d'Àgueda Micó, realitzada a la seua entrevista a La Represa.	cc-by-sa-4.0
Veu de Víctor Pàmies i Riudor.ogg	Veu de Víctor Pàmies i Riudor enregistrada a la Casa Orlandai el mes de març de 2017.	cc-by-sa-3.0
Sento parla de la trilogia del Dr. Uriel.ogg	Seixanta-uné programa de La Represa. Entrevista amb Sento Llobell	cc-by-sa-4.0
Sento Llobell - voice.ogg	Seixanta-uné programa de La Represa. Entrevista amb Sento Llobell	cc-by-sa-4.0
La Represa - Ràdio Godella - 17-02-2017.ogg	Seixanta-uné programa de La Represa. Entrevista amb Sento Llobell	cc-by-sa-4.0
La Represa - Ràdio Godella - 14-04-2017.ogg	Entrevista amb Ernest Garcia. La Represa, Ràdio Godella	CC-BY-SA 4.0
Ernest Garcia - voice.ogg	Autopresentació d'Ernest Garcia, realitzada a la seua entrevista a La Represa.	CC-BY-SA 4.0
La Tarara (Serra).ogg	Cançons de Pasqua: La Tarara, Estos tres dies de Pasqua-Xúmbala cantades per veïnes de Serra	PermissionTicket|id=2016111410011367|user=Ruthven
Entrevista Federico Montagud - Colp a Colp 52.ogg	Entrevista amb Federico Montagud.	CC-BY-SA 4.0
Montaner i Coeter - Colp a Colp 49.ogg	Declaracions de Montaner i Coeter II de cara a l'inici de la XXIV Lliga Professional de Raspall	CC-BY-SA 4.0
Javi i Nacho - Colp a Colp 51.ogg	Javi i Nacho analitzen l'última partida de semifinals de la XXVI Lliga Professional d'Escala i Corda.	CC-BY-SA 4.0
Prèvia Final Lliga EiC 2017 - Colp a Colp 52.ogg	Prèvia a la primera partida de la final. El trinqueter Adrián, Soro i Pere-Roc.	CC-BY-SA 4.0
Andreu Banyuls - voice.ogg	Autopresentació d'Andreu Banyuls	CC-BY-SA 4.0
La Represa - Ràdio Godella - 5-04-2017.ogg	Entrevista amb Andreu Banyuls, 72 edició de La Represa.	CC-BY-SA 4.0
Colp a Colp 54 - XXVI Lliga d'Escala i Corda.ogg	Declaracions per al programa 54 de Colp a Colp.<br /> Javi i Monrabal analitzen la segona partida de la final.	CC-BY-SA 4.0
Declaracions Baldu (maig 2017).ogg	Declaracions per al programa 54 de Colp a Colp.	CC-BY-SA 4.0
Colp a Colp 54 - Semifinals XXIV Lliga Raspall.ogg	Declaracions per al programa 54 de Colp a Colp.<br />Sergio, Brisca, Ian i Sanchis analitzen els trinquets de les semifinals en la roda de premsa posterior al sorteig de les seus.	CC-BY-SA 4.0
Antonio Estañ - voice.ogg	Autopresentació d'Antonio Estañ. Enregistrada a La Represa, Ràdio Godella, Xarxa d'Emissores Municipals Valencianes.	cc-by-sa-4.0
La Represa - Ràdio Godella - 7-4-2017.ogg	Entrevista amb Antonio Estañ. Enregistrada a La Represa, Ràdio Godella, Xarxa d'Emissores Municipals Valencianes.	cc-by-sa-4.0
Miguel Hache - voice.ogg	Autopresentació de Miguel Hache extreta de l'entrevista a 'La Represa' (Ràdio Godella, Xarxa d'Emissores Municipals Valencianes) estrenada el 2 de desembre de 2016	cc-by-sa-4.0
La Represa - Ràdio Godella - 2-12-2016.ogg	Entrevista a Miguel Hache a 'La Represa' (Ràdio Godella, Xarxa d'Emissores Municipals Valencianes) estrenada el 2 de desembre de 2016	cc-by-sa-4.0
Víctor Maceda - voice.ogg	Autopresentació de Víctor Maceda, enregistrada al programa ''La Represa''.	cc-by-sa-4.0
Dolors Escamilla - voice.ogg	Autopresentació de Dolors Escamilla, enregistrada al programa ''La Represa''.	cc-by-sa-4.0
La Represa - Ràdio Godella - 23-06-2017.ogg	Entrevista amb Víctor Maceda, estrenada el 23 de juny de 2017.	cc-by-sa-4.0
La Represa - Ràdio Godella - 30-06-2017.ogg	Entrevista amb Dolors Escamilla, estrenada el 30 de juny de 2017.	cc-by-sa-4.0
Joan Francesc Mira - voice.ogg	Mostra de veu de Joan Francesc Mira, del programa "La Represa".	cc-by-sa-4.0
La Represa - Ràdio Godella - 07-07-2017.ogg	Entrevista amb Joan Francesc Mira a "La Represa", enregistrada al Museu Valencià d'Etnologia en febrer de 2017 i estrenada a Ràdio Godella el juliol del mateix any.	cc-by-sa-4.0
Seguidillas de Titaguas - 2 (8-A).ogg	Seguidillas interpretades per la Rondalla de Titaguas, en 1975.	CC-BY-SA 4.0
Seguidillas de Titaguas (8-A).ogg	Seguidillas interpretades per la Rondalla de Titaguas, en 1975.	CC-BY-SA 4.0
Toque de Bandúrria - Titaguas (8-A).ogg	Toc de Bandúrria interpretada pel Tío Pedro de la Rondalla de Titaguas.	CC-BY-SA 4.0
Jota de Baile - Titaguas (8-A).ogg	Jota de Ball representada per la Rondalla de Titaguas.	CC-BY-SA 4.0
Jota Parada - Titaguas (8-A).ogg	Jota Parada representada per la Rondalla de Titaguas.	CC-BY-SA 4.0
Toque de Guitarra - Titaguas -2 (8-A).ogg	Toc de Guitarra interpretat per la Rondalla de Titaguas.	CC-BY-SA 4.0
Toque de Guitarra - Titaguas (8-A).ogg	Toc de Guitarra interpretat per la Rondalla de Titaguas.	CC-BY-SA 4.0
En casa del señor cura - Fuenterrobles (8-A).ogg	En casa del señor cura, cançó infantil.	CC-BY-SA 4.0
El zarambú - Missa del gall - Fuenterrobles (8-A).ogg	El zarambú, nadala de la missa del gall.	CC-BY-SA 4.0
La virgen tiene corona - Jota parada - Macastre (8-A).ogg	La virgen tiene corona, jota parada de Macastre	CC-BY-SA 4.0
Presentació Josefa Sierra Broch - Macastre (8-A).ogg	Presentació de Josefa Sierra Broch	CC-BY-SA 4.0
Mi morena me ayudó - Canción de Trilla - Macastre (8-A).ogg	Mi morena me ayudó, canción de trilla de Macastre	CC-BY-SA 4.0
Tonada 2 - Jota de baile - Macastre (8-A).ogg	jota de baile de Macastre	CC-BY-SA 4.0
Tonada 1 - Jota de baile - Macastre (8-A).ogg	jota de baile de Macastre	CC-BY-SA 4.0
Valencianes de quintos - Macastre (8-A).ogg	Recull de valencianes de quintos de Macastre	CC-BY-SA 4.0
Yo entré un día a ver la Virgen - Jota parada - Macastre (8-A).ogg	Yo entré un día a ver la virgen, jota parada de Macastre	CC-BY-SA 4.0
Entrevista Rafael Soler, León - Colp a Colp 61.ogg	Entrevista amb León després d'anunciar la seua retirada.	CC-BY-SA 4.0
Entrevista Punxa - Colp a Colp 56.ogg	Entrevista a Àngel Gregori Roig, ''Punxa'', després de la lesió de desembre de 2016.	CC-BY-SA 4.0
La Represa - Ràdio Godella - 16-06-2017.ogg	Entrevista amb Toni Mollà, realitzada a Ràdio Godella.	cc-by-sa-4.0
La Represa - Ràdio Godella - 26-05-2017.ogg	Entrevista amb Eduard Mira, realitzada a Ràdio Godella.	cc-by-sa-4.0
Albaes - Macastre (8-A).ogg	Albaes, Macastre.	CC-BY-SA 4.0
Ana le dijo un día a San Antonio - Macastre (8-A).ogg	Romance, Macastre.	CC-BY-SA 4.0
El Séptimo Dolor - Macastre (8-A).ogg	Dolores de la Virgen, Macastre.	CC-BY-SA 4.0
El Uno (1) - Macastre (8-A).ogg	Canto de Lucimiento, Macastre.	CC-BY-SA 4.0
El Uno (2) - Macastre (8-A).ogg	Canto de Lucimiento, Macastre.	CC-BY-SA 4.0
Matraca - Macastre (8-A).ogg	Cançó infantil, Macastre.	CC-BY-SA 4.0
Nana - Macastre (8-A).ogg	Cançó de bressol, Macastre.	CC-BY-SA 4.0
Oración a la Virgen de Tejeda - Macastre (8-A).ogg	Oración de Ciegos, Macastre.	CC-BY-SA 4.0
Oración a la Virgen del Carmen - Macastre (8-A).ogg	Oración de ciegos, Macastre.	CC-BY-SA 4.0
Oración a San Antón - Macastre (8-A).ogg	Oración de ciegos, Macastre.	CC-BY-SA 4.0
Carmela o la Mala Suegra - Macastre (8-A).ogg	Romance, Macastre.	CC-BY-SA 4.0
La Represa - Ràdio Godella - 15-09-2017.ogg	Entrevista amb Carles Viñas	cc-by-sa-4.0
La Represa - Ràdio Godella - 22-09-2017.ogg	Programa extraordinari amb un debat entre Josep Sorribes i David Estal	cc-by-sa-4.0
Semis Individual Raspall 2017 - Colp a Colp 70.ogg	Resum de la primera semifinal i prèvia de la segona, per Jordi Coll i amb declaracions d'Ian entrgistrades per Ulisses Ortiz.	CC-BY-SA 4.0
La Represa - Ràdio Godella - 27-10-2017.ogg	Entrevista al periodista Quico Arabí.	cc-by-sa-4.0
Maria Abradelo - voice.ogg	Autopresentació de Maria Abradelo.	cc-by-sa-4.0
La Represa - Ràdio Godella - 03-11-2017.ogg	Entrevista amb Maria Abradelo.	cc-by-sa-4.0
Quico Arabí - voice.ogg	Autopresentació de Francesc Arabí	cc-by-sa-4.0
Maria Fuster - voice.ogg	Autopresentació de Maria Fuster	cc-by-sa-4.0
Joan Oleaque - voice.ogg	Autopresentació de Joan Oleaque.	cc-by-sa-4.0
Juliet d'Alginet, discurs com a fill predilecte.mp3	El 26-02-1999 Juliet d'Alginet va ser nomenat fill predilecte de la localitat. Ací està el breu discurs que feu.	cc-by-sa-4.0
Discurs de Juliet d'Alginet, 1999.mp3	El 26-02-1999 Juliet d'Alginet va ser nomenat fill predilecte de la localitat. Ací està el breu discurs que feu.	cc-by-sa-4.0
Cianovirina.oggtheora.ogv	Estructura tridimensional de Cianovirina-N	cc-by-sa-4.0
Vicent Olmos - voice.mp3	Autopresentació de Vicent Olmos, 67 edició de La Represa.	CC-BY-SA 4.0
La Represa - Ràdio Godella - 31-03-2017.mp3	Entrevista amb Vicent Olmos, 67 edició de La Represa.	CC-BY-SA 4.0
Martí Estruch i Axmacher - veu.ogg	veu de Martí Estruch i Axmacher enregistrada el març de 2021	cc-zero
Joe Jacobi - veu.ogg	Veu de l'esportista Joseph Bennet Jacobi, "Joe Jacobi", enregistrada el març de 2021 per al viquiprojecte de la Veu és Lliure	cc-0
Ignasi Doñate i Sanglas - veu.ogg	Veu d'Ignasi Doñate i Sanglas, advocat, polític i activista cultural català, enregistrada el març de 2021	cc-zero
Héctor López Bofill - veu.ogg	Veu d'Héctor López Bofill, jurista i escriptor català, enregistrada el febrer de 2021	cc-zero
Júlia - "El mecanoscrit" - 02 "El mecanoscrit".ogg	Júlia - "El mecanoscrit" - 02 "El mecanoscrit"	cc-by-sa-3.0
Júlia - "El mecanoscrit" - 01 "Illes".ogg	Júlia - "El mecanoscrit" - 01 "Illes"	cc-by-sa-3.0
Júlia - "El mecanoscrit" - 03 "Era glacial".ogg	Júlia - "El mecanoscrit" - 03 "Era glacial"	cc-by-sa-3.0
Júlia - "El mecanoscrit" - 04 "El desert d'Amphibia".ogg	Júlia - "El mecanoscrit" - 04 "El desert d'Amphibia"	cc-by-sa-3.0
Júlia - "El mecanoscrit" - 05 "Turbo Somnis".ogg	Júlia - "El mecanoscrit" - 05 "Turbo Somnis"	cc-by-sa-3.0
Júlia - "El mecanoscrit" - 07 "Alpino".ogg	Júlia - "El mecanoscrit" - 07 "Alpino"	cc-by-sa-3.0
Júlia - "El mecanoscrit" - 06 "Terranova".ogg	Júlia - "El mecanoscrit" - 06 "Terranova"	cc-by-sa-3.0
Waldo Vila - voice.mp3	Voice Intro Project de Waldo	cc-by-sa-4.0
Nerea Sanfe - voice.mp3	Autopresentació de Nerea Sanfe	cc-by-sa-4.0
Carles Porta i Gaset - veu.ogg	Veu de Carles Porta i Gaset, periodista i escriptor català, enregistrada l'abril de 2021	cc-zero
Manèl Zabala Sánchez - veu.ogg	Veu de Manèl Zabala Sánchez, periodista, escriptor i traductor, enregistrada el maig de 2021	cc-zero
De mon camí.ogg	Selecció de poemes. Remei Morlius.	cc-by-sa-4.0
Feliu Formosa i Torres - veu.ogg	Veu de Feliu Formosa i Torres, escriptor, poeta, traductor i actor català, enregistrada el maig de 2021	cc-zero
Tractat del Pet.ogg	Tractat del Pet_Obres festives	cc-by-sa-4.0
Epístola a un amic, de Francesc Vicent Garcia i Ferrandis (dècima 6).ogg	Tall de veu de la dècima 6 de l'obra «Epístola a un amic», de Francesc Vicent Garcia i Ferrandis (s. XVII). Enregistrat per Francesc Xavier Dengra i Grau per al projecte Viquitexts, en la campanya «Donants de veu» de la primavera de 2021.	cc-by-sa-4.0
Epístola a un amic, de Francesc Vicent Garcia i Ferrandis (dècima 9).ogg	Tall de veu de la dècima 9 de l'obra «Epístola a un amic», de Francesc Vicent Garcia i Ferrandis (s. XVII). Enregistrat per Francesc Xavier Dengra i Grau per al projecte Viquitexts, en la campanya «Donants de veu» de la primavera de 2021.	cc-by-sa-4.0
Epístola a un amic, de Francesc Vicent Garcia i Ferrandis (dècima 5).ogg	Tall de veu de la dècima 5 de l'obra «Epístola a un amic», de Francesc Vicent Garcia i Ferrandis (s. XVII). Enregistrat per Francesc Xavier Dengra i Grau per al projecte Viquitexts, en la campanya «Donants de veu» de la primavera de 2021.	cc-by-sa-4.0
Epístola a un amic, de Francesc Vicent Garcia i Ferrandis (dècima 12).ogg	Tall de veu de la dècima 12 de l'obra «Epístola a un amic», de Francesc Vicent Garcia i Ferrandis (s. XVII). Enregistrat per Francesc Xavier Dengra i Grau per al projecte Viquitexts, en la campanya «Donants de veu» de la primavera de 2021.	cc-by-sa-4.0
Epístola a un amic, de Francesc Vicent Garcia i Ferrandis (dècima 10).ogg	Tall de veu de la dècima 10 de l'obra «Epístola a un amic», de Francesc Vicent Garcia i Ferrandis (s. XVII). Enregistrat per Francesc Xavier Dengra i Grau per al projecte Viquitexts, en la campanya «Donants de veu» de la primavera de 2021.	cc-by-sa-4.0
Epístola a un amic, de Francesc Vicent Garcia i Ferrandis (dècima 13).ogg	Tall de veu de la dècima 13 de l'obra «Epístola a un amic», de Francesc Vicent Garcia i Ferrandis (s. XVII). Enregistrat per Francesc Xavier Dengra i Grau per al projecte Viquitexts, en la campanya «Donants de veu» de la primavera de 2021.	cc-by-sa-4.0
Epístola a un amic, de Francesc Vicent Garcia i Ferrandis (dècima 16).ogg	Tall de veu de la dècima 16 de l'obra «Epístola a un amic», de Francesc Vicent Garcia i Ferrandis (s. XVII). Enregistrat per Francesc Xavier Dengra i Grau per al projecte Viquitexts, en la campanya «Donants de veu» de la primavera de 2021.	cc-by-sa-4.0
Epístola a un amic, de Francesc Vicent Garcia i Ferrandis (dècima 18).ogg	Tall de veu de la dècima 18 de l'obra «Epístola a un amic», de Francesc Vicent Garcia i Ferrandis (s. XVII). Enregistrat per Francesc Xavier Dengra i Grau per al projecte Viquitexts, en la campanya «Donants de veu» de la primavera de 2021.	cc-by-sa-4.0
Epístola a un amic, de Francesc Vicent Garcia i Ferrandis (dècima 15).ogg	Tall de veu de la dècima 15 de l'obra «Epístola a un amic», de Francesc Vicent Garcia i Ferrandis (s. XVII). Enregistrat per Francesc Xavier Dengra i Grau per al projecte Viquitexts, en la campanya «Donants de veu» de la primavera de 2021.	cc-by-sa-4.0
Epístola a un amic, de Francesc Vicent Garcia i Ferrandis (dècima 35).ogg	Tall de veu de la dècima 35 de l'obra «Epístola a un amic», de Francesc Vicent Garcia i Ferrandis (s. XVII). Enregistrat per Francesc Xavier Dengra i Grau per al projecte Viquitexts, en la campanya «Donants de veu» de la primavera de 2021.	cc-by-sa-4.0
Epístola a un amic, de Francesc Vicent Garcia i Ferrandis (dècima 45).ogg	Tall de veu de la dècima 45 de l'obra «Epístola a un amic», de Francesc Vicent Garcia i Ferrandis (s. XVII). Enregistrat per Francesc Xavier Dengra i Grau per al projecte Viquitexts, en la campanya «Donants de veu» de la primavera de 2021.	cc-by-sa-4.0
Epístola a un amic, de Francesc Vicent Garcia i Ferrandis (dècima 51).ogg	Tall de veu de la dècima 51 de l'obra «Epístola a un amic», de Francesc Vicent Garcia i Ferrandis (s. XVII). Enregistrat per Francesc Xavier Dengra i Grau per al projecte Viquitexts, en la campanya «Donants de veu» de la primavera de 2021.	cc-by-sa-4.0
Epístola a un amic, de Francesc Vicent Garcia i Ferrandis (dècima 65).ogg	Tall de veu de la dècima 65 de l'obra «Epístola a un amic», de Francesc Vicent Garcia i Ferrandis (s. XVII). Enregistrat per Francesc Xavier Dengra i Grau per al projecte Viquitexts, en la campanya «Donants de veu» de la primavera de 2021.	cc-by-sa-4.0
Epístola a un amic, de Francesc Vicent Garcia i Ferrandis (dècima 66).ogg	Tall de veu de la dècima 66 de l'obra «Epístola a un amic», de Francesc Vicent Garcia i Ferrandis (s. XVII). Enregistrat per Francesc Xavier Dengra i Grau per al projecte Viquitexts, en la campanya «Donants de veu» de la primavera de 2021.	cc-by-sa-4.0
Mestre Olaguer, d'Àngel Guimerà (1896; portada).ogg	Tall de veu de la portada de «Mestre Olaguer», d'Àngel Guimerà i Jorge (1896). Enregistrat per Francesc Xavier Dengra i Grau per al projecte Viquitexts, en la campanya «Donants de veu» de la primavera de 2021.	cc-zero
Mestre Olaguer, d'Àngel Guimerà (1896; avís legal).ogg	Tall de veu de l'avís legal de l'obra «Mestre Olaguer», d'Àngel Guimerà i Jorge (1896). Enregistrat per Francesc Xavier Dengra i Grau per al projecte Viquitexts, en la campanya «Donants de veu» de la primavera de 2021.	cc-zero
Mestre Olaguer, d'Àngel Guimerà (1896; obra central).ogg	Tall de veu del monòleg complet de «Mestre Olaguer», d'Àngel Guimerà i Jorge (1896). Enregistrat per Francesc Xavier Dengra i Grau per al projecte Viquitexts, en la campanya «Donants de veu» de la primavera de 2021.	cc-zero
Café Montcau - Carmelina Sánchez-Cutillas (23-05-2008).ogg	Entrevista amb Carmelina Sánchez Cutillas, realitzada per Joan Borja el 23 de maig de 2008	cc-by-sa-4.0
Ayoransa, de Victòria Peña i Nicolau (1859).ogg	Tall de veu d'«Anyoransa», de Victòria Peña i Nicolau a l'obra «Jochs Florals de Barcelona en 1859». Enregistrat per Francesc Xavier Dengra i Grau per al projecte Viquitexts, en la campanya «Donants de veu» de la primavera de 2021.	cc-zero
La Creu de Cristo, d'Isabel de Villamartín.ogg	Tall de veu de «La Veu de Cristo», d'Isabel Villamartín a l'obra «Jochs Florals de Barcelona en 1861». Enregistrat per Francesc Xavier Dengra i Grau per al projecte Viquitexts, en la campanya «Donants de veu» de la primavera de 2021.	cc-zero
Una tarda per mar, de Joaquim Ruyra.ogg	Aquesta és la primera narració del llibre "Impressions", dins del volum "Pinya de rosa", publicat l'any 1920. Conta l'experiència d'un noi que en comptes d'anar a classe s'escapa amb una colla d'amics per anar a pescar amb la barca.	cc-by-sa-4.0
Plaça de l'Ajuntament de Calella-Catalunya.ogg	Plaça de l'Ajuntament de Calella-Catalunya en un dia de pluja.	cc-by-sa-4.0
Plaça de Catalunya (Calella-Catalunya) 01.ogg	Plaça de Catalunya (Calella-Catalunya)	cc-by-sa-4.0
No em pren així com el petit vailet - Anna Ruiz.mp3	Lectura del poema ''No em pren així com el petit vailet'', d'Ausiàs March	cc-by-sa-4.0
Si com lo taur sen va fruit pel desert - Anna Ruiz.mp3	Lectura del poema ''Si com lo taur sen va fruit pel desert'', d'Ausiàs March	cc-by-sa-4.0
Ruïnes de la Calella romana.ogg	Ruïnes de la Calella romana. Vídeo des del sud de les ruïnes en direcció nord.	cc-by-sa-4.0
Isabel de Galceran. Capítol 1.ogg	Enregistrament del capítol 1 d'Isabel de Galceran de Narcís Oller en el marc del Projecte "Donants de veu". https://ca.wikisource.org/wiki/Isabel_de_Galceran. Lectura en 6 arxius, essent aquest el primer de sis.	cc-by-sa-4.0
Isabel de Galceran. Capítol 3.ogg	Enregistrament del capítol 3 d'Isabel de Galceran de Narcís Oller en el marc del Projecte "Donants de veu". https://ca.wikisource.org/wiki/Isabel_de_Galceran. Lectura en 6 arxius, essent aquest el tercer de sis.	cc-by-sa-4.0
Isabel de Galceran. Capítol 2.ogg	Enregistrament del capítol 2 d'Isabel de Galceran de Narcís Oller en el marc del Projecte "Donants de veu". https://ca.wikisource.org/wiki/Isabel_de_Galceran. Lectura en 6 arxius, essent aquest el segon de sis.	cc-by-sa-4.0
Isabel de Galceran. Capítol 4.ogg	Enregistrament del capítol 4 d'Isabel de Galceran de Narcís Oller en el marc del Projecte "Donants de veu". https://ca.wikisource.org/wiki/Isabel_de_Galceran. Lectura en 6 arxius, essent aquest el quart de sis.	cc-by-sa-4.0
Isabel de Galceran. Capítol 6.ogg	Enregistrament del capítol 6 d'Isabel de Galceran de Narcís Oller en el marc del Projecte "Donants de veu". https://ca.wikisource.org/wiki/Isabel_de_Galceran. Lectura en 6 arxius, essent aquest el sisè de sis.	cc-by-sa-4.0
Isabel de Galceran. Capítol 5.ogg	Enregistrament del capítol 5 d'Isabel de Galceran de Narcís Oller en el marc del Projecte "Donants de veu". https://ca.wikisource.org/wiki/Isabel_de_Galceran. Lectura en 6 arxius, essent aquest el cinquè de sis.	cc-by-sa-4.0
"Lo jorn ha por de perdre sa claror" d'Ausiàs March.ogg	Col·laboració per augmentar els clàssics en català en audiolectures.	PD-US-expired
"Colguen les gents amb alegria festes" d'Ausiàs March.ogg	Col·laboració per augmentar els clàssics en català en audiolectures.	PD-US-expired
"Lleixant a part l'estil dels trobadors" d'Ausiàs March.ogg	Col·laboració per augmentar els clàssics en català en audiolectures.	PD-US-expired
"Quins tan segurs consells vas encercant" d'Ausiàs March.ogg	Col·laboració per augmentar els clàssics en català en audiolectures.	PD-US-expired
"Així com cell qui en lo somni es delita" d'Ausiàs March.ogg	Col·laboració per augmentar els clàssics en català en audiolectures.	PD-US-expired
"No em fall record de temps tan delitós" d'Ausiàs March.ogg	Col·laboració per augmentar els clàssics en català en audiolectures.	PD-US-expired
"Veles e vents han mos desigs complir" d'Ausiàs March.ogg	Col·laboració per augmentar els clàssics en català en audiolectures.	PD-US-expired
"A Mallorca, durant la guerra civil" complet.ogg	Lectura de "A Mallorca, durant la guerra civil", de Bartomeu Rosselló-Pòrcel, per Elisabeth Torrescassana i Marcé	cc-by-sa-4.0
Joan Reig i Solé - veu.ogg	Veu de Joan Reig i Solé, músic català, enregistrada el 4 d'agost de 2021.	cc-zero
Dolors Sabater parlant de les ruïnes de la Calella romana, 2021.ogg	Dolors Sabater, 2021 en una roda premsa feta al Parc Dalmau sobre les ruïnes de la Calella romana	cc-by-sa-4.0
Jessica González Herrera a Calella.ogg	Jessica González Herrera fent una roda de premsa al Parc Dalmau de Calella, recolzant la campanya per la recuperació de la Calella romana.	cc-by-sa-4.0
La Papallona capítol 02 àudio.ogg	La Papallona. Àudio de la novel·la de Marià Vayreda i Vila extreta de Librivox i narrada per jpujolar	cc-zero
La Papallona capítol 03 àudio.ogg	La Papallona. Àudio de la novel·la de Marià Vayreda i Vila extreta de Librivox i narrada per jpujolar	cc-zero
La Papallona capítol 01 àudio.ogg	La Papallona. Àudio de la novel·la de Marià Vayreda i Vila extreta de Librivox i narrada per jpujolar	cc-zero
La Papallona capítol 04 àudio.ogg	La Papallona. Àudio de la novel·la de Marià Vayreda i Vila extreta de Librivox i narrada per jpujolar	cc-zero
La Papallona capítol 05 àudio.ogg	La Papallona. Àudio de la novel·la de Marià Vayreda i Vila extreta de Librivox i narrada per jpujolar	cc-zero
La Papallona capítol 06 àudio.ogg	La Papallona. Àudio de la novel·la de Marià Vayreda i Vila extreta de Librivox i narrada per jpujolar	cc-zero
La Papallona capítol 07 àudio.ogg	La Papallona. Àudio de la novel·la de Marià Vayreda i Vila extreta de Librivox i narrada per jpujolar	cc-zero
La Papallona capítol 09 àudio.ogg	La Papallona. Àudio de la novel·la de Marià Vayreda i Vila extreta de Librivox i narrada per jpujolar	cc-zero
La Papallona capítol 08 àudio.ogg	La Papallona. Àudio de la novel·la de Marià Vayreda i Vila extreta de Librivox i narrada per jpujolar	cc-zero
La Papallona capítol 10 àudio.ogg	La Papallona. Àudio de la novel·la de Marià Vayreda i Vila extreta de Librivox i narrada per jpujolar	cc-zero
La Papallona capítol 11 àudio.ogg	La Papallona. Àudio de la novel·la de Marià Vayreda i Vila extreta de Librivox i narrada per jpujolar	cc-zero
La Papallona capítol 12 àudio.ogg	La Papallona. Àudio de la novel·la de Marià Vayreda i Vila extreta de Librivox i narrada per jpujolar	cc-zero
La Papallona capítol 13 àudio.ogg	La Papallona. Àudio de la novel·la de Marià Vayreda i Vila extreta de Librivox i narrada per jpujolar	cc-zero
La Papallona capítol 14 àudio.ogg	La Papallona. Àudio de la novel·la de Marià Vayreda i Vila extreta de Librivox i narrada per jpujolar	cc-zero
La Papallona capítol 15 àudio.ogg	La Papallona. Àudio de la novel·la de Marià Vayreda i Vila extreta de Librivox i narrada per jpujolar	cc-zero
La Papallona capítol 16 àudio.ogg	La Papallona. Àudio de la novel·la de Marià Vayreda i Vila extreta de Librivox i narrada per jpujolar	cc-zero
La Papallona capítol 17 àudio.ogg	La Papallona. Àudio de la novel·la de Marià Vayreda i Vila extreta de Librivox i narrada per jpujolar	cc-zero
La Papallona capítol 18 àudio.ogg	La Papallona. Àudio de la novel·la de Marià Vayreda i Vila extreta de Librivox i narrada per jpujolar	cc-zero
La Papallona capítol 19 àudio.ogg	La Papallona. Àudio de la novel·la de Marià Vayreda i Vila extreta de Librivox i narrada per jpujolar	cc-zero
La Papallona capítol 20 àudio.ogg	La Papallona. Àudio de la novel·la de Marià Vayreda i Vila extreta de Librivox i narrada per jpujolar	cc-zero
De quan les besties parlaven-2 La cigonya, la llebre i el cocodril.ogg	Segon capítol de l'obra.	cc-zero
De quan les bèsties parlaven-1 El cèrvol i la tortuga.ogg	Primer capítol de l'obra	cc-zero
De quan les besties parlaven-3 L elefant i el borinot.ogg	Tercer capítol de l'obra.	cc-zero
De quan les besties parlaven-4 El camell, el dromedari i la daina.ogg	Quart capítol de l'obra.	cc-zero
De quan les besties parlaven-6 El gat i la rata.ogg	Sisè capítol de l'obra.	cc-zero
De quan les besties parlaven-5 El paó, l oca, la rata sàvia i les gallines aduladores.ogg	Cinquè capítol de l'obra.	cc-zero
De quan les bèsties parlaven-7 Rat-penat gran i Rat-penat xic.ogg	Setè capítol de l'obra.	cc-zero
De quan les bèsties parlaven-9 L òliba i el gos de Sant Roc.ogg	Novè capítol de l'obra.	cc-zero
De quan les bèsties parlaven-10 Les zebres i el cavallet.ogg	Desè capítol de l'obra.	cc-zero
De quan les bèsties parlaven-8 El peix espasa, el tauró i els peixos mofeta.ogg	Vuitè capítol de l''obra.	cc-zero
De quan les bèsties parlaven-11 El lleó del desert i l ossa de les neus.ogg	Últim capítol de l'obra.	cc-zero
Mona Hatoum - voice.mp3	Voice Intro Project de Mona Hatoum (editat per llevar soroll de fons)	cc-by-sa-4.0
Mona Hatoum - voice (2).mp3	Voice Intro Project de Mona Hatoum (sense editar)	cc-by-sa-4.0
Antoni Miró - voice.mp3	Voice Intro project d'Antoni Miró	cc-by-sa-4.0
Hon és lo lloch on ma pensa repose - Anna Ruiz.mp3	Lectura del poema ''Hon és lo lloch on ma pensa repose'', d'Ausiàs March	cc-by-sa-4.0
Guillermo Ros - IVAM 2021.mp3	Guillermo Ros parla de la seua exposició a l'IVAM.	CC-BY-SA 4.0
Guillermo Ros - voice - ca.mp3	Voice Intro project de Guillermo Ros.	CC-BY-SA 4.0
Guillermo Ros - voice - es.mp3	Voice Intro project de Guillermo Ros.	CC-BY-SA 4.0
Representació a la Fira Medieval de Calella 2021.ogg	Representació a la Fira Medieval de Calella 2021 a la plaça de l'Església.	cc-by-sa-4.0
Srdjan Dragojevic - voice.mp3	Voice Intro project de Srdjan Dragojevic, enregistrada a la Mostra de Cinema del 2021	cc-by-sa-4.0
Jota valenciana a les Jornades Internacionals Folklòriques de Catalunya a Calella (vídeo).ogg	Jota valenciana a les Jornades Internacionals Folklòriques de Catalunya a Calella (per una màxima resolució seleccioneu ''font ogg'' del desplegable que apareix en clicar la icona de la flor en la barra de visualització de baix del vídeo)	cc-by-sa-4.0
Sergi Castillo - voice.mp3	Veu de Sergi Castillo	cc-by-sa-4.0
Irene Rodrigo - voice.mp3	Voice Intro Project d'Irene Rodrigo	cc-by-sa-4.0
Copeo d'Ontinyent a les Jornades Internacionals Folklóriques de Catalunya a Calella.ogg	Copeo d'Ontinyent a les Jornades Internacionals Folklóriques de Catalunya a Calella	cc-by-sa-4.0
Dansa d'Equador a les Jornades Internacionals Folklóriques de Catalunya a Calella.ogg	Dansa d'Equador a les Jornades Internacionals Folklóriques de Catalunya a Calella	cc-by-sa-4.0
ClimentBarber.20161129.EpistolesFarcides.ogg	Mn Climent i Barber descriu la Epístola farcida Sant Esteve	cc-by-sa-4.0
Sabadell Airport - Plane decelerates after landing.ogg	Una avioneta redueix gradualment la seva velocitat després d'aterrar a l'Aeroport de Sabadell.	cc-by-sa-4.0
Saray Cerro - voice.mp3	Voice Intro de Saray Cerro	cc-by-sa-4.0
La Represa - Ràdio Godella - 14-01-2022.mp3	Entrevista a Saray Cerro en La Represa, gener del 2022	cc-by-sa-4.0
Pau Vidal Gavilán - veu.ogg	Veu de Pau Vidal Gavilán, filòleg, traductor i escriptor català, enregistrada el gener de 2022	cc-zero
Fandango d'Aiora.ogg	Fandango d'Aiora a Calella en les Jornades internacionals Folklòriques de Catalunya.	cc-by-sa-4.0
Els Segadors (Instrumental).ogg	Versió Instrumental Oficial dels Segadors	cc-zero
La Balanguera.ogg	La Balanguera	cc-zero
Ricard Soler Roger (veu).ogg	Mostra de veu de Ricard Soler Roger	cc-by-sa-4.0
SenyorOca (veu).ogg	Mostra de veu de Sergi Sala (Senyor Oca)	cc-zero
Fran Rodríguez Grau (veu).ogg	Mostra de veu de Fran Rodríguez Grau	cc-zero
Carles Prats Padrós (veu).ogg	Mostra de veu de Carles Prats Padrós.	cc-zero
Maria Sevilla Paris (veu).ogg	Mostra de veu de Maria Sevilla Paris.	cc-zero
Albert Roig Antó (veu).ogg	Mostra de veu d'Albert Roig Antó.	cc-zero
Joana Vilapuig (veu).ogg	Mostra de veu de Joana Vilapuig Borrell.	cc-zero
Lluís Soler (veu).ogg	Mostra de veu de Lluís Soler Auladell.	cc-zero
Ferran Palau (veu).ogg	Mostra de veu de Ferran Palau.	cc-zero
Marc Balaguer (veu).ogg	Mostra de veu de Marc Balaguer Roca.	cc-zero
Pere Escobar (veu).ogg	Mostra de veu de Pere Escobar Royo.	cc-zero
Neus Bonet (veu).ogg	Mostra de veu de Neus Bonet Bagant.	cc-zero
Ferran Audí (veu).ogg	Mostra de veu de Ferran Audí.	cc-zero
Damià Rodríguez (veu).ogg	Mostra de veu de Damià Rodríguez.	cc-zero
Salvador Vergés Cubí (veu).ogg	Mostra de veu de Salvador Vergés Cubí.	cc-zero
Guim Valls (veu).ogg	Mostra de veu de Guim Valls.	cc-zero
Quintí Cristià (veu).ogg	Mostra de veu de Quintí Cristià.	cc-zero
Daura Mangara (veu).ogg	Mostra de veu de Daura Mangara.	cc-zero
Jordi Prat i Coll (veu).ogg	Mostra de veu de Jordi Prat i Coll.	cc-zero
Adolfo Obiang Biko - voice.mp3	Voice Intro d'Adolfo Obiang Biko	cc-by-sa-4.0
Oriol Sauleda (veu).ogg	Mostra de veu d'Oriol Sauleda.	cc-zero
La Represa - Ràdio Godella - 11-02-2022.mp3	Entrevista a Adolfo Obiang Biko	cc-by-sa-4.0
Motacilla cinerea in Sant Cugat del Valles 20220212.ogg	Cant de Cuereta Torrentera (Motacilla cinerea)	cc-by-sa-4.0
Lia Ibáñez (veu).ogg	Mostra de veu de Lia Ibáñez.	cc-zero
Magalí Sare (veu).ogg	Mostra de veu de Magalí Sare.	cc-zero
Magda Puyo (veu).ogg	Mostra de veu de Magda Puyo Bové.	cc-zero
Victoria Szpunberg (veu).ogg	Mostra de veu de Victoria Szpunberg Witt.	cc-zero
Marc Rosich (veu).ogg	Mostra de veu de Marc Rosich.	cc-zero
Ferran Llagostera Coll (veu).ogg	Mostra de veu de Ferran Llagostera i Coll.	cc-zero
Blanca Bardagil (veu).ogg	Mostra de veu de Blanca Bardagil Mas.	cc-zero
Sergi Cervera (veu).ogg	Mostra de veu de Sergi Cervera.	cc-zero
Carla Simón (veu).ogg	Mostra de veu de Carla Simón.	cc-zero
Carlos Latre (veu).ogg	Mostra de veu de Carlos Latre Ruiz.	cc-zero
Borja Penalba (veu).ogg	Mostra de veu de Borja Penalba Català.	cc-zero
Albert Elfa Canut (veu).ogg	Mostra de veu d'Albert Elfa Canut.	cc-zero
Miquel Duran Portas (veu).ogg	Mostra de veu de Miquel Duran Portas.	cc-zero
Les bambuneres.mp3	Cançó dedicada a les treballadores de les Papeleras Reunidas.	cc-by-sa-4.0
Alguer Miquel (veu).ogg	Mostra de veu d'Alguer Miquel i Bo.	cc-zero
Nerea Sanfe - voice - ca.mp3	Voice Intro Project de Nerea Sanfe amb data corregida	cc-by-sa-4.0
SuenaWiki Podcast E5-T4.mp3	Cinqué episodi de la quarta temporada de SuenaWiki.	cc-by-sa-4.0
SuenaWiki Podcast E6-T4.mp3	Sisé episodi de la quarta temporada de SuenaWiki.	cc-by-sa-4.0
SuenaWiki Podcast E4-T4.mp3	Quart episodi de la quarta temporada de SuenaWiki.	cc-by-sa-4.0
Joan Sanchis - voice.mp3	Voice Intro de Joan Sanchis	cc-by-sa-4.0
Enric Navarro - voice.mp3	Voice Intro d'Enric Navarro	cc-by-sa-4.0
Roger Olmos (veu).ogg	Mostra de veu de Roger Olmos.	cc-zero
Pau Vallvé (veu).ogg	Mostra de veu de Pau Vallvé.	cc-zero
Albert Bosch (veu).ogg	Mostra de veu d'Albert Bosch.	cc-zero
Raül Garrigasait i Colomés (veu).ogg	Mostra de veu de Raül Garrigasait i Colomés.	cc-zero
Rosa Font (veu).ogg	Mostra de veu de Rosa Font.	cc-zero
Isabel Banal (veu).ogg	Mostra de veu d'Isabel Banal.	cc-zero
Alícia Puertas (veu).ogg	Mostra de veu d'Alícia Puertas.	cc-zero
Raimon Ávila (veu).ogg	Mostra de veu de Raimon Ávila.	cc-zero
Enric Nolla (veu).ogg	Mostra de veu d'Enric Nolla.	cc-zero
Gerard Furest i Dalmau (veu).ogg	Tall de veu de Gerard Furest i Dalmau, mestre de secundària i sindicalista català	cc-zero
Immaculada Cerdà - voice.mp3	Voice intro d'Immaculada Cerdà	cc-by-sa-4.0
Paloma Chen - voice.mp3	Voice Intro project de Paloma Chen	cc-by-sa-4.0
La Represa - Ràdio Godella - 3-06-2022.mp3	Entrevista amb Paloma Chen	cc-by-sa-4.0
Jaume C. Pons Alorda (veu).ogg	Mostra de veu de Jaume Cristòfol Pons Alorda.	cc-zero
David Castillo Buïls (veu).ogg	Mostra de veu de David Castillo Buïls.	cc-zero
Anna Gas (veu).ogg	Mostra de veu d'Anna Gas Serra.	cc-zero
Josep Moliner Pedrós (veu).ogg	Mostra de veu de Josep Moliner i Pedrós.	cc-zero
Claudia Vega (veu).ogg	Mostra de veu de Claudia Vega.	cc-zero
Marc Egea (veu).ogg	Mostra de veu de Marc Egea.	cc-zero
Jordi Sugranyes (veu).ogg	Mostra de veu de Jordi Sugranyes.	cc-zero
Mireia Tejero (veu).ogg	Mostra de veu de Mireia Tejero.	cc-zero
Àngels Gregori (veu).ogg	Mostra de veu d'Àngels Gregori.	cc-zero
SuenaWiki Podcast E7-T4.mp3	Seté episodi de la quarta temporada de SuenaWiki.	cc-by-sa-4.0
Manel Barceló (veu).ogg	Mostra de veu de Manel Barceló.	cc-zero
Àngels Moreno (veu).ogg	Mostra de veu d'Àngels Moreno.	cc-zero
Marcel·lí Antúnez Roca (veu).ogg	Veu de Marcel·lí Antúnez Roca.	cc-zero
Ferran Suay (veu).ogg	Mostra de veu de Ferran Suay.	cc-zero
SuenaWiki Podcast E9-T4.mp3	Nové episodi de la quarta temporada de SuenaWiki.	cc-by-sa-4.0
SuenaWiki Podcast E8-T4.mp3	Huité episodi de la quarta temporada de SuenaWiki.	cc-by-sa-4.0
Francesc Garrido (veu).ogg	Mostra de veu de Francesc Garrido.	cc-zero
Eduard Escoffet (veu).ogg	Mostra de veu d'Eduard Escoffet.	cc-zero
Mariola Dinarès (veu).ogg	Mostra de veu de Mariola Dinarès.	cc-zero
Gerard Pastor (veu).ogg	Mostra de veu de Gerard Pastor.	cc-zero
Xavier Batllés (veu).ogg	Mostra de veu de Xavier Batllés.	cc-zero
Miquel Pujadó (veu).ogg	Mostra de veu de MIquel Pujadó.	cc-zero
Rosa Maria Poch Claret (veu).ogg	Tall de veu de presentació de l'enginyera agrònoma i edafòloga catalana Rosa Maria Poch Claret, enregistrat al 22è Congrés de Ciències del Sòl, celebrat a Glasgow (Escòcia) l'agost del 2022.	cc-zero
Lu Rois (veu).ogg	Mostra de veu de Lu Rois.	cc-zero
Dansa dels Cavallets - El Corpus.mp3	Reproducció de la música del Corpus realitzada al Centre de la Beneficiència en motiu de l'exposició de l'Etno.	cc-by-sa-4.0
Dansa dels Turcs - El Corpus.mp3	Reproducció de la música del Corpus realitzada al Centre de la Beneficiència en motiu de l'exposició de l'Etno.	cc-by-sa-4.0
Dansa dels arquets - El Corpus.mp3	Reproducció de la música del Corpus realitzada al Centre de la Beneficiència en motiu de l'exposició de l'Etno.	cc-by-sa-4.0
Dansa dels Nanos - El Corpus.mp3	Reproducció de la música del Corpus realitzada al Centre de la Beneficiència en motiu de l'exposició de l'Etno.	cc-by-sa-4.0
Dansa de les Vetes - El Corpus.mp3	Reproducció de la música del Corpus realitzada al Centre de la Beneficiència en motiu de l'exposició de l'Etno.	cc-by-sa-4.0
Dansa dels Gegants - El Corpus.mp3	Reproducció de la música del Corpus realitzada al Centre de la Beneficiència en motiu de l'exposició de l'Etno.	cc-by-sa-4.0
La degolla - El Corpus.mp3	Reproducció de la música del Corpus realitzada al Centre de la Beneficiència en motiu de l'exposició de l'Etno.	cc-by-sa-4.0
La Moma - El Corpus.mp3	Reproducció de la música del Corpus realitzada al Centre de la Beneficiència en motiu de l'exposició de l'Etno.	cc-by-sa-4.0
Dansa de la Magrana - Corpus de València.mp3	Reproducció de la música del Corpus realitzada al Centre de la Beneficiència en motiu de l'exposició de l'Etno.	cc-by-sa-4.0
Pastorets - El Corpus.mp3	Reproducció de la música del Corpus realitzada al Centre de la Beneficiència en motiu de l'exposició de l'Etno.	cc-by-sa-4.0
Dansa dels Llauradors - Corpus de València.mp3	Reproducció de la música del Corpus realitzada al Centre de la Beneficiència en motiu de l'exposició de l'Etno.	cc-by-sa-4.0
Jordi Manent (veu).ogg	Mostra de veu de Jordi Manent.	cc-zero
Laura Pérez - Voice.mp3	Voice Intro project de Laura Pérez Granel, realitzada a les Jornades de còmic de València	cc-by-sa-4.0
Ferran Burguillos (veu).ogg	Mostra de veu de Ferran Burguillos.	cc-zero
La Nigérienne.ogg	La Nigérienne	cc-zero
Andrés Corchero (veu).ogg	Mostra de veu d'Andrés Corchero.	cc-zero
Viquipèdia bola 3D - Mapa Ballester - Queta (animació).ogg	Animació d'una Queta, figureta molt associada a l'ús del català a principis del segle XXI, a través d'un exemplar reeditat del Mapa Ballester dels Països Catalans (obra de Joan Ballester i Canals l'any 1932). De fons, una Viquibola de la Viquipèdia impresa en 3D, farcida de plantes.	cc-by-sa-4.0
La Represa - Ràdio Godella - 7-10-2022.mp3	Entrevista al músic Alfons Pérez Daràs, el Blüe	cc-by-sa-4.0
SuenaWiki Podcast E1T5.mp3	Primer episodi de la cinquena temporada de SuenaWiki.	cc-by-sa-4.0
Voice - Kaltrina Krasniqi.mp3	Voice Intro project de Kaltrina Krasniqi	cc-by-sa-4.0
Voice - Kaltrina Krasniqi - clean.mp3	Voice Intro project de Kaltrina Krasniqi	cc-by-sa-4.0
Cláudia Varejão - Lobo e Cão.mp3	Cláudia Varejão parla sobre la pel·lícula Lobo e Cão	cc-by-sa-4.0
Voice - Erige Sehiri - fr.mp3	Voice Intro project d'Erige Sehiri  en francès	cc-by-sa-4.0
Voice - Erige Sehiri - ar.mp3	Voice Intro project d'Erige Sehiri en àrab	cc-by-sa-4.0
Voice Ali Asgari - en.mp3	Ali Asgari a la Mostra de València - 1	cc-by-sa-4.0
Voice Ali Asgari - fa.mp3	Ali Asgari a la Mostra de València	cc-by-sa-4.0
Gina Tost (veu).ogg	Mostra de veu de Gina Tost.	cc-zero
Voice - Alfons Pérez.mp3	Voice Intro Project d'Alfons Pérez	cc-by-sa-4.0
Voice - Charly Efe.mp3	Voice Intro Project - Charly Efe	cc-by-sa-4.0
Ali Asgari - roda de premsa.mp3	Ali Asgari, a la roda de premsa de la Mostra de València, parlant sobre la pel·lícula Ta Farda.	cc-by-sa-4.0
Ali Asgari - Ta Farda - Actresses.mp3	Ali Asgari, a la roda de premsa de la Mostra de València, parlant sobre el procés de trobar actors per a la pel·lícula Ta Farda.	cc-by-sa-4.0
Voice - Teko.mp3	Voice Intro Project - Teko	cc-by-sa-4.0
Manel Vizcaíno (veu).ogg	Mostra de veu de Manel Vizcaíno.	cc-zero
Joan Deusa (veu).ogg	Mostra de veu de Joan Deusa.	cc-zero
Marc Monzó (veu).ogg	Mostra de veu de Marc Monzó.	cc-zero
Joan Sala i Torrent (veu).ogg	Mostra de veu de Joan Sala i Torrent.	cc-zero
Blanca Llum Vidal (veu).ogg	Mostra de veu de Blanca Llum Vidal.	cc-zero
Anna Navarro Descals (veu).ogg	Mostra de veu d'Anna Navarro Descals.	cc-zero
Jordi Martí Font (veu).ogg	Mostra de veu Jordi Martí Font.	cc-zero
Andreu González Castro (veu).ogg	Mostra de veu d'Andreu González Castro.	cc-zero
Josep Pedrals (veu).ogg	Mostra de veu de Josep Pedrals.	cc-zero
Xiva de Morella - Virolai.mp3	Virolai, en versió cantada als Ports de Morella.	cc-by-sa-4.0
Maria Josep Escrivà (veu).ogg	Mostra de veu de Maria Josep Escrivà.	cc-zero
Jordi Núñez - El que sabem.mp3	El director de la pel·lícula en parla	cc-by-sa-4.0
Figa Flawas - veu.ogg	Tall de veu dels integrants del grup musical en català Figa Flawas, enregistrat el novembre del 2022	cc-zero
ToniCruanyesPlana.ogg	Mostra de veu de n'Antoni Cruanyes i Plana.	cc-0
Àngels Marzo (veu).ogg	Mostra de veu d'Àngels Marzo.	cc-zero
TomaMolinaBosch.ogg	Mostra de veu d'en Tomàs Molina i Bosch.	cc-0
Cesc Cornet (veu).ogg	Mostra de veu de Cesc Cornet.	cc-zero
Clara Che - voice.mp3	Voice Intro Project de Clara Che	cc-by-sa-4.0
Clara Che - voice - edited.mp3	Voice Intro Project de Clara Che	cc-by-sa-4.0
RogerPera(veu).ogg	Mostra de veu d'en Roger Pera (inclou uns segons finals fent d'Spiderman en català i castellà).	cc-0
LluísCanutPermanyer(veu).ogg	Mostra de veu d'en Lluís Canut Permanyer.	cc-0
EsteveSolerGranel(veu).ogg	Mostra de veu del periodista català Esteve Soler Granel.	cc-0
JoseCorbachoNieto(veu).ogg	Mostra de veu d'en Jose Corbacho Nieto.	cc-0
Carme Manuel - voice.mp3	Voice Intro Project de Carme Manuel	cc-by-sa-4.0
Txe Arana (veu).ogg	Mostra de veu de Txe Arana.	cc-zero
LídiaHeredia(veu).ogg	Mostra de veu de la periodista Lídia Heredia.	cc-0
DavidVerdaguerRuiz(veu).ogg	Mostra de veu de l'actor català David Verdaguer Ruiz.	cc-0
JoanPeraSegura(veu).ogg	Mostra de veu de l'actor Joan Pera Segura.	cc-0
Carol Rodríguez i Colás (veu).ogg	Enregistrament de veu de Carol Rodríguez i Colás l'any 2022.	cc-zero
XaviCoralTrullàs(veu).ogg	Mostra de veu del periodista català Xavi Coral Trullàs.	cc-0
Гимн Республики Алтай (2001).ogg	Гимн Республики Алтай (2001)	cc-by-sa-4.0
MartaRomagosa(veu).ogg	Mostra de veu de la periodista i escriptora Marta Romagosa.	cc-0
ToniClapésCasals(veu).ogg	Mostra de veu del radiofonista Toni Clapés Casals.	cc-0
QuimMoralesPrat(veu).ogg	Mostra de veu del radiofonista Quim Morales Prat.	cc-zero
Xavier Duran i Escriba (veu).ogg	Enregistrament de veu del 2022 del químic, periodista científic, escriptor i divulgador català Xavier Duran i Escriba (Barcelona, 1959).	cc-zero
Lucile Hadžihalilović - voice.mp3	Voice Intro project de Lucile Hadžihalilović, enregistrat a la Plaça de l'Ajuntament de València durant la Mostra 2023	cc-by-sa-4.0
Àlex Hinojo (veu).ogg	Mostra de veu d'Àlex Hinojo.	cc-zero
FrancescMauriDomènech(veu).ogg	Mostra de veu del meteoròleg de la CCMA, Francesc-Marc Mauri i Domènech.	cc-zero
NúriaSoléPérez(veu).ogg	Mostra de veu de la periodista Núria Solé Pérez.	cc-zero
MariPauHuguetSubias(veu).ogg	Mostra de veu de la presentadora de televisió catalana Mari Pau Huguet.	cc-zero
JoelDíazBraña(veu).ogg	Mostra de veu del comunicador i humorista català Joel Díaz.	cc-zero
Albert Velasco i Gonzàlez (veu).ogg	Enregistrament de veu de l'historiador de l'art, comissari i professor català Albert Velasco i Gonzàlez (n. Lleida, 1976)	cc-zero
SuenaWiki T5-E4.mp3	Quart episodi de la cinquena temporada de SuenaWiki	cc-by-sa-4.0
MiquelPucurullFontova(veu).ogg	Mostra de veu del corredor Miquel Pucurull Fontova "Pucu".	cc-zero
RamonPeris-March(veu).ogg	Mostra de veu de l'actor català Ramon Peris-March. En Petri durant els 10 primers anys (1991-2001) del primer Club Super3.	cc-zero
IreneRigauOliver(veu).ogg	Mostra de veu de la psicòloga i política catalana Irene Rigau i Oliver.	cc-zero
AriadnaOltraMartí(veu).ogg	Mostra de veu de la periodista catalan Ariadna Oltra i Martí.	cc-zero
MontserratTuraCamafreita(veu).ogg	Mostra de veu de la metgessa, política i assagista catalana Montserrat Tura i Camafreita.	cc-zero
ImmaPedemonteSarañana(veu).ogg	Mostra de veu la periodista esportiva catalana Imma Pedemonte i Sarañana.	cc-zero
ToniSolerGuasch(veu).ogg	Mostra de veu del periodista català Toni Soler i Guasch.	cc-zero
TomeuPenya(veu).ogg	Mostra de veu del cantautor mallorquí Tomeu Penya.	cc-zero
Maria Nicolau i Rocabayera (veu).ogg	Enregistrament de veu de la cuinera i col·laboradora televisiva catalana Maria Nicolau i Rocabayera (la Garriga, 1982) l'any 2023.	cc-zero
ArturPegueraAnoro(veu).ogg	Mostra de veu del periodista català Artur Peguera Anoro.	cc-zero
ÒscarAndreuFernández(veu).ogg	Mostra de veu de n'Òscar Andreu i Fernández.	cc-zero
Miguelanxo Prado - voice.mp3	Veu de Miguelanxo Prado, a un acte a La Nau de València	cc-by-sa-4.0
Miguelanxo Prado - voice (edit).mp3	Veu de Miguelanxo Prado, a un acte a La Nau de València	cc-by-sa-4.0
EduardBoetDomènech(veu).ogg	Mostra de veu del periodista català Eduard Boet i Domènech.	cc-zero
PereRafartArza(veu).ogg	Mostra de veu de l'il·lusionista Pere Rafart Arza.	cc-zero
RamonPellicerColillas(veu).ogg	Mostra de veu del periodista Ramon Pellicer Colillas.	cc-zero
ArcadiAlibésRiera(veu).ogg	Mostra de veu del periodista esportiu Arcadi Alibés Riera.	cc-zero
JuditMartinDulcet(veu).ogg	Mostra de veu de la comedianta Judit Martin Dulcet.	cc-zero
SuenaWiki Podcast - T5E6.mp3	Sexto episodio de la quinta temporada de SuenaWiki.	cc-by-sa-4.0
SuenaWiki Podcast - T5E5.mp3	Quinto episodio de la quinta temporada de SuenaWiki.	cc-by-sa-4.0
AntoniBassasOnieva(veu).ogg	Mostra de veu del periodista Antoni Bassas i Onieva.	cc-zero
IsidreEstevePujol(veu).ogg	Mostra de veu del pilot d'automobilisme Isidre Pujol Esteve.	cc-zero
Ester Franquesa (veu).ogg	Mostra de veu d'Ester Franquesa.	cc-zero
MontseArmengouMartín(veu).ogg	Mostra de veu de la periodista catalana Montse Armengou i Martín.	cc-zero
SergiLópezAyats(veu).ogg	Mostra de veu de l'actor català Sergi López i Ayats.	cc-zero
RaquelSansDuran(veu).ogg	Mostra de veu de la periodista catalana Raquel Sans Duran.	cc-zero
NatzaFarréMaduell(veu).ogg	Mostra de veu de la periodista i comunicadora feminista catalana Natza Farré i Maduell.	cc-zero
MarcGiróCosta(veu).ogg	Mostra de veu de l'historiador de l'art i periodista català Marc Giró i Costa.	cc-zero
BielDuranPascual(veu).ogg	Mostra de veu de l'actor català Biel Duran i Pascual.	cc-zero
EmmaVilarasauTomàs(veu).ogg	Mostra de veu de l'actriu catalana Emma Vilarasau Tomàs.	cc-zero
ElenaGadel(veu).ogg	Mostra de veu la cantant i actriu catalana n'Elena Gadel.	cc-zero
Gessamí Boada (veu).ogg	Mostra de veu de Gessamí Boada.	cc-zero
Manuel Lillo i Usechi (veu).ogg	Mostra de veu de Manuel Lillo i Usechi.	cc-zero
FalinCáceresCano(veu).ogg	Mostra de veu del baixista d'Els Pets, Rafael (Falin) Cáceres i Cano	cc-zero
LluísGavaldàRoig(veu).ogg	Mostra de veu del cantant d'Els Pets, i músic, Lluís Gavaldà Roig.	cc-zero
Agustí Franch (veu).ogg	Mostra de veu d'Agustí Franch.	cc-zero
Albert Jané veu.ogg	Fragment de veu de l'escriptor, traductor i lingüista Albert Jané	cc-by-sa-4.0
MontseMirallesBrugués(veu).ogg	Mostra de veu de l'actriu i directora catalana Montse Miralles i Brugués.	cc-zero
Jofre Bardagí (veu).ogg	Mostra de veu de Jofre Bardagí.	cc-zero
FrancescXavierBonastreThió(veu).ogg	Mostra de veu del periodista esportiu català Francesc Xavier Bonastre Thió	cc-zero
XavierBoschSancho(veu).ogg	Mostra de veu del periodista Xavier Bosch i Sancho.	cc-zero
CarmeRuscalledaSerra(veu).ogg	Mostra de veu de la cuinera catalana Carme Ruscalleda i Serra.	cc-zero
Xavier Mas Craviotto (veu).ogg	Mostra de veu de Xavier Mas Craviotto.	cc-zero
FrancescPidelaSerraValero(veu).ogg	Mostra de veu del cantautor català Francesc Pi de la Serra i Valero.	cc-zero
Antoni Ros Marbà (veu).ogg	Mostra de veu d'Antoni Ros Marbà.	cc-zero
Maria José Català - voice.mp3	Voice Intro Project de María José Català Verdet	cc-by-sa-4.0
Maria José Català - voice corregit 01.mp3	Voice Intro Project de María José Català Verdet	cc-by-sa-4.0
Josep Rodríguez Ferrer (veu).ogg	Mostra de veu de Josep Rodríguez Ferrer.	cc-zero
EnricCalpenaOllé(veu).ogg	Mostra de veu del periodista, professor i historiador Enric Calpena i Ollé.	cc-zero
NilCardonerGratacós(veu).ogg	Mostra de veu de l'actor català Nil Cardoner i Gratacós.	cc-zero
Stage 4 Volta a Catalunya 2023, Guillaume Boivin leads out the sprint.ogg	Guillaume Boivin (Israel-Premier Tech) llança l'esprint per a Corbin Strong en la quarta etapa de la Volta a Catalunya 2023, a Sabadell.	cc-by-sa-4.0
Oriol Estrada Rangil (veu).ogg	Mostra de veu d'Oriol Estrada Rangil.	cc-zero
Xavier Serrat (veu).ogg	Mostra de veu de Xavier Serrat Crespo.	cc-zero
PuritoJoaquimRodríguezOliver(veu).ogg	Mostra de veu del ciclista  "Purito" Joaquim Rodríguez i Oliver.	cc-zero
JordiPuntíGarriga(veu).ogg	Mostra de veu de l'escriptor català Jordi Puntí i Garriga.	cc-zero
JoelJoanJuvé(veu).ogg	Mostra de veu de l'actor català Joel Joan i Juvé.	cc-zero
MàriusSerraRoig(veu).ogg	Mostra de veu de l'escriptor Màrius Serra i Roig.	cc-zero
Sergio Manzanera - voice - edited.mp3	Voice Intro project de Sergio Manzanera	cc-by-sa-4.0
Antón - voice - edited.mp3	Voice Intro project d'Antón Martínez Morales	cc-by-sa-4.0
Sergio Manzanera - voice.mp3	Voice Intro project de Sergio Manzanera	cc-by-sa-4.0
Antón - voice.mp3	Voice Intro project d'Antón Martínez Morales	cc-by-sa-4.0
Salvador Vergés i Tejero (veu).ogg	Mostra de veu de Salvador Vergés i Tejero.	cc-zero
CarmeJunyentFigueras(veu).ogg	Mostra de veu de la lingüista catalana Maria Carme Junyent i Figueras.	cc-zero
Anna-Costal-i-Fornells (veu).ogg	Mostra de veu d'Anna Costal i Fornells.	cc-zero
RogerEscapaFarrés(veu).ogg	Mostra de veu del periodista sabadellenc Roger Escapa Farrés.	cc-zero
ManelAlíasTort(veu).ogg	Mostra de veu del periodista català Manel Alías Tort.	cc-zero
ArturBlascoGiné(veu).ogg	Mostra de veu del músic, investigador i divulgador del folklore català Artur Blasco i Giné.	cc-zero
Júlia Bacardit (veu).ogg	Mostra de veu de Júlia Bacardit.	cc-zero
Martí Mora Julià, Sr Chen (veu).ogg	Mostra de veu de Martí Mora Julià.	cc-zero
AngelsGonyalons(veu).ogg	Mostra de veu de l'actriu Àngels Gonyalons.	cc-zero
AlexGorinaMacia(veu).ogg	Mostra de veu del crític de cinema i presentador català Àlex Gorina i Macià.	cc-zero
Lluís Roura Juanola (veu).ogg	Mostra de veu de Lluís Roura Juanola.	cc-zero
Oriol Carcolse Marinel·lo (veu).ogg	Mostra de veu d'Oriol Carcolse Marinel·lo (Nel·lo).	cc-zero
JoanFortunyGuarro(veu).ogg	Mostra de veu del músic català Joan Fortuny Guarro.	cc-zero
LluísFortunyGuarro(veu).ogg	Mostra de veu del músic català Lluís Fortuny i Guarro.	cc-zero
Phylloscopus bonelli.ogg	Cant del Mosquiter pàl·lid	cc-by-sa-4.0
Lo Catalanisme - Valentí Almirall - 0 - pròleg 01.ogg	Capítol del àudio llibre "Lo Catalanisme" de l'autor Valentí Almirall	cc-zero
Lo Catalanisme - Valentí Almirall - 0 - pròleg 02.ogg	Capítol del àudio llibre "Lo Catalanisme" de l'autor Valentí Almirall	cc-zero
Lo Catalanisme - Valentí Almirall - 0 - pròleg 03.ogg	Capítol del àudio llibre "Lo Catalanisme" de l'autor Valentí Almirall	cc-zero
Lo Catalanisme - Valentí Almirall - 0 - pròleg 04.ogg	Capítol del àudio llibre "Lo Catalanisme" de l'autor Valentí Almirall	cc-zero
Lo Catalanisme - Valentí Almirall - 0 - pròleg 05.ogg	Capítol del àudio llibre "Lo Catalanisme" de l'autor Valentí Almirall	cc-zero
Lo Catalanisme - Valentí Almirall - 0 - pròleg 06.ogg	Capítol del àudio llibre "Lo Catalanisme" de l'autor Valentí Almirall	cc-zero
Lo Catalanisme - Valentí Almirall - 0 - pròleg 07.ogg	Capítol del àudio llibre "Lo Catalanisme" de l'autor Valentí Almirall	cc-zero
Lo Catalanisme - Valentí Almirall - 0 - pròleg 08.ogg	Capítol del àudio llibre "Lo Catalanisme" de l'autor Valentí Almirall	cc-zero
Lo Catalanisme - Valentí Almirall - 0 - pròleg 09.ogg	Capítol del àudio llibre "Lo Catalanisme" de l'autor Valentí Almirall	cc-zero
Lo Catalanisme - Valentí Almirall - 0 - pròleg 10.ogg	Capítol del àudio llibre "Lo Catalanisme" de l'autor Valentí Almirall	cc-zero
Lo Catalanisme - Valentí Almirall - 0 - pròleg 11.ogg	Capítol del àudio llibre "Lo Catalanisme" de l'autor Valentí Almirall	cc-zero
Lo Catalanisme - Valentí Almirall - 0 - pròleg 12.ogg	Capítol del àudio llibre "Lo Catalanisme" de l'autor Valentí Almirall	cc-zero
Lo Catalanisme - Valentí Almirall - 0 - pròleg 13.ogg	Capítol del àudio llibre "Lo Catalanisme" de l'autor Valentí Almirall	cc-zero
Lo Catalanisme - Valentí Almirall - 0 - pròleg 14.ogg	Capítol del àudio llibre "Lo Catalanisme" de l'autor Valentí Almirall	cc-zero
Lo Catalanisme - Valentí Almirall - 0 - pròleg 15.ogg	Capítol del àudio llibre "Lo Catalanisme" de l'autor Valentí Almirall	cc-zero
Lo Catalanisme - Valentí Almirall - 0 - pròleg 16.ogg	Capítol del àudio llibre "Lo Catalanisme" de l'autor Valentí Almirall	cc-zero
Lo Catalanisme - Valentí Almirall - 0 - pròleg 17.ogg	Capítol del àudio llibre "Lo Catalanisme" de l'autor Valentí Almirall	cc-zero
Lo Catalanisme - Valentí Almirall - 0 - pròleg 18.ogg	Capítol del àudio llibre "Lo Catalanisme" de l'autor Valentí Almirall	cc-zero
Lo Catalanisme - Valentí Almirall - 0 - pròleg 19.ogg	Capítol del àudio llibre "Lo Catalanisme" de l'autor Valentí Almirall	cc-zero
Lo Catalanisme - Valentí Almirall - 0 - pròleg 20.ogg	Capítol del àudio llibre "Lo Catalanisme" de l'autor Valentí Almirall	cc-zero
Lo Catalanisme - Valentí Almirall - 0 - pròleg 21.ogg	Capítol del àudio llibre "Lo Catalanisme" de l'autor Valentí Almirall	cc-zero
Lo Catalanisme - Valentí Almirall - 0 - pròleg 22.ogg	Capítol del àudio llibre "Lo Catalanisme" de l'autor Valentí Almirall	cc-zero
PolGise(veu).ogg	Mostra de veu de l'actor i youtuber català Pol Gise.	cc-zero
Jordi Boixaderas veu.ogg	Fragment de veu del locutor, actor i rapsode Jordi Boixaderas	cc-by-sa-4.0
Roc Casagran veu.ogg	Fragment de veu de l'escriptor i professor Roc Casagran	cc-by-sa-4.0
AntonioBañosBoncompain(audio).ogg	Mostra de veu del periodista català Antonio Baños i Boncompain.	cc-zero
BernatSolerPla(veu).ogg	Mostra de veu del periodista esportiu Bernat Soler i Pla.	cc-zero
JuditMascóPalau(veu).ogg	Mostra de veu de la model i presentadora de televisió Judit Mascó i Palau.	cc-zero
Llorenç Balsach veu2023.ogg	Fragment de veu del compositor Llorenç Balsach i Peig	cc-by-sa-4.0
Jaume Garcia Arija (veu).ogg	Fragment de veu de l'actor Jaume Garcia Arija	cc-by-sa-4.0
EnricGomàRibas(veu).ogg	Mostra de veu del guionista, escriptor i divulgador lingüístic català Enric Gomà i Ribas.	cc-zero
MarinaRossellFigueras(veu).ogg	Mostra de veu de la cantant Marina Rossell i Figueras.	cc-zero
JaumeSisaMestres(veu).ogg	Mostra de veu del music i cantautor Jaume Sisa i Mestres.	cc-zero
Júlia Ojeda i Caba - veu.ogg	Veu de Júlia Ojeda i Caba, investigadora i crítica literària catalana, enregistrada el juny del 2023	cc-zero
MariaRodríguezSoto(veu).ogg	Mostra de veu de l'actriu Maria Rodríguez Soto.	cc-zero
MikiEsparbéGener(veu).ogg	Mostra de veu de l'actor Miki Esparbé Gener.	cc-zero
LauraRoselSolà(veu).ogg	Mostra de veu de la periodista Laura Rosel i Solà.	cc-zero
QuecoFrancescNovellClausells(veu).ogg	Mostra de veu del periodista, actor i humorista Francesc (Queco) Novell i Clausells.	cc-zero
BrunaCusíEchaniz(veu).ogg	Mostra de veu de l'actriu Bruna Cusí Echaniz.	cc-zero
Josep M. Pladevall (veu).ogg	Fragment de veu del compositor i professor de flauta de bec català Josep M. Pladevall i Fontanet	cc-by-sa-4.0
KílianSebriàMarsol(veu).ogg	Mostra de veu del periodista Kílian Sebrià i Marsol.	cc-zero
Jep Barceló (veu).ogg	Tall de veu de l'actor Jep Barceló	cc-by-sa-4.0
FrancescSolerLlagostera(veu).ogg	Mostra de veu del periodista i escriptor Francesc Soler i Llagostera.	cc-zero
VicentPartalMontesinos(veu).ogg	Mostra de veu del periodista Vicent Partal i Montesinos.	cc-zero
PepSalaBellavista(veu).ogg	Mostra de veu del músic Pep Sala i Bellavista.	cc-zero
JulianaCanetPedemonte(veu).ogg	Mostra de veu de la comunicadora Juliana Canet i Pedemonte.	cc-zero
RicardUstrellGarrido(veu).ogg	Mostra del periodista Ricard Ustrell i Garrido.	cc-zero
RafaeldeRibotTorroella.ogg	Mostra de veu del periodista Rafael de Ribot i Torroella.	cc-zero
DavidGuzman(veu).ogg	Mostra de veu del periodista David Guzman.	cc-zero
张琳艳 - voice.mp3	La futbolista xinesa Zhang Linyan	YouTube CC-BY|中国新闻社
Voces de EntretELA J Ramon Calabuig (Poeta).ogg	Gravació de poemes del llibre EntretELA de Ramon Calabuig	cc-by-sa-4.0
Josep Ministral (veu).ogg	Mostra de veu de Josep Ministral.	cc-zero
Armand Olivé (veu).ogg	Mostra de veu d'Armand Olivé.	cc-zero
Carles Coll (veu).ogg	Mostra de veu de Carles Coll.	cc-zero
Jaume Cristau (veu).ogg	Mostra de veu de Jaume Cristau.	cc-zero
Floréal Martorell (veu).ogg	Mostra de veu de Floréal Martorell.	cc-zero
Josep Nogué i Felip - veu.ogg	Veu en català de l'economista i activista social català Josep Nogué i Felip, enregistrada el 20 de març del 2023.	cc-zero
Joan-Lluís Lluís (veu).ogg	Veu en català de l'escriptor, traductor i columnista català Joan-Lluís Lluís, enregistrada l'11 de juny del 2023.	cc-zero
Anna Maria Bofarull (veu).ogg	Mostra de veu d'Anna Maria Bofarull.	cc-zero
Elies Barberà (veu).ogg	Mostra de veu d'Elies Barberà.	cc-zero
Josep Piera (veu).ogg	Mostra de veu de Josep Piera.	cc-zero
Joan Magrané (veu).ogg	Mostra de veu de Joan Magrané.	cc-zero
Jordi Roura Llauradó (veu).ogg	Mostra de veu de Jordi Roura Llauradó.	cc-zero
Anna Pantinat (veu).ogg	Mostra de veu d'Anna Pantinat.	cc-zero
Laura López Granell (veu).ogg	Mostra de veu de Laura López Granell.	cc-zero
Cèlia Sànchez-Mústich (veu).ogg	Mostra de veu de Cèlia Sànchez-Mústich.	cc-zero
Florenci Salesas (veu).ogg	Mostra de veu de Florenci Salesas.	cc-zero
DavidFernàndezRamos(veu).ogg	Mostra de veu del periodista David Fernàndez i Ramos.	cc-zero
Ramon Humet (veu).ogg	Mostra de veu de Ramon Humet.	cc-zero
Joan-Daniel Bezsonoff (veu).ogg	Mostra de veu de Joan-Daniel Bezsonoff.	cc-zero
Fèlix Edo Tena (veu).ogg	Mostra de veu de Fèlix Edo Tena.	cc-zero
Sebas Martín (veu).ogg	Mostra de veu de Sebas Martín.	cc-zero
Guillem Medina (veu).ogg	Mostra de veu de Guillem Medina.	cc-zero
August Bover Font (veu).ogg	Mostra de veu d'August Bover Font.	cc-zero
AlfredRodríguezPicó(veu).ogg	Mostra de veu del meteoròleg català Alfred Rodríguez Picó.	cc-zero
Raquel Santanera (veu).ogg	Mostra de veu de Raquel Santanera.	cc-zero
Elies Barberà (veu).ogg	Mostra de veu d'Elies Barberà.	cc-zero
Josep Piera (veu).ogg	Mostra de veu de Josep Piera.	cc-zero
Joan Magrané (veu).ogg	Mostra de veu de Joan Magrané.	cc-zero
Jordi Roura Llauradó (veu).ogg	Mostra de veu de Jordi Roura Llauradó.	cc-zero
Anna Pantinat (veu).ogg	Mostra de veu d'Anna Pantinat.	cc-zero
Laura López Granell (veu).ogg	Mostra de veu de Laura López Granell.	cc-zero
Cèlia Sànchez-Mústich (veu).ogg	Mostra de veu de Cèlia Sànchez-Mústich.	cc-zero
Florenci Salesas (veu).ogg	Mostra de veu de Florenci Salesas.	cc-zero
DavidFernàndezRamos(veu).ogg	Mostra de veu del periodista David Fernàndez i Ramos.	cc-zero
Ramon Humet (veu).ogg	Mostra de veu de Ramon Humet.	cc-zero
Joan-Daniel Bezsonoff (veu).ogg	Mostra de veu de Joan-Daniel Bezsonoff.	cc-zero
Fèlix Edo Tena (veu).ogg	Mostra de veu de Fèlix Edo Tena.	cc-zero
Sebas Martín (veu).ogg	Mostra de veu de Sebas Martín.	cc-zero
Guillem Medina (veu).ogg	Mostra de veu de Guillem Medina.	cc-zero
August Bover Font (veu).ogg	Mostra de veu d'August Bover Font.	cc-zero
AlfredRodríguezPicó(veu).ogg	Mostra de veu del meteoròleg català Alfred Rodríguez Picó.	cc-zero
Raquel Santanera (veu).ogg	Mostra de veu de Raquel Santanera.	cc-zero
Xavier Aliaga (veu).ogg	Mostra de veu de Xavier Aliaga.	cc-zero
TaniaTapiaDíaz(veu).ogg	Mostra de veu de la periodista na Tania Tapia Díaz.	cc-zero
Vicenç Altaió (veu).ogg	Mostra de veu de Vicenç Altaió.	cc-zero
Jordi Armadans (veu).ogg	Mostra de veu de Jordi Armadans.	cc-zero
Quim Bigas (veu).ogg	Mostra de veu de Quim Bigas.	cc-zero
MaiolRogerHoms(veu).ogg	Mostra de veu del periodista Maiol Roger Homs.	cc-zero
CarmeSansaAlbert(veu).ogg	Mostra de veu de l'actriu Carme Sansa i Albert.	cc-zero
EstelSoléCasadellà(veu).ogg	Mostra de veu de l'escriptora i actriu Estel Solé i Casadellà.	cc-zero
AmparoMorenoGarrigós(veu).ogg	Mostra de veu de l'actriu Amparo Moreno Garrigós.	cc-zero
MercheMar(veu).ogg	Mostra de veu de vedet de revista i music hall Merche Mar.	cc-zero
Antoni Soler Ricart (veu).ogg	Mostra de veu d'Antoni Soler Ricart.	cc-zero
Luis Carlos Díaz - voice.mp3	Autopresentació de Luis Carlos Díaz, realitzada per a la seua entrevista a La Represa	cc-by-sa-3.0
La Represa - Ràdio Godella - 24-03-2017.mp3	Entrevista a Luis Carlos Díaz, 66 edició de La Represa.	cc-by-sa-3.0
Lalo Kubala - voice.mp3	Introducció de veu de Lalo Kubala. Extret del Noranta-dosé programa de "La Represa", emés a Ràdio Godella el 12 de gener de 2018.	cc-by-sa-4.0
La Represa - Ràdio Godella - 09-10-2019.mp3	Entrevista amb Jordi Sebastià, periodista i eurodiputat.	CC-BY-SA 4.0
Jordi Sebastià - voice.mp3	Voice Intro Project de Jordi Sebastià	cc-by-sa-4.0
Audio la banalitat del mal gerard.ogg	Àudio sobre l'article La banalitat del mal de la Viquipèdia en català, locutat per Gerard Guerrero en el marc del projecte Be the key.	cc-by-sa-4.0
Ca islamofobia maria.ogg	Àudio de l'article Islamofòbia locutat per Maria.	cc-by-sa-4.0
Ca eco mitologia georgina.ogg	Àudio de l'article Eco (mitologia) locutat per Georgina Pahissa.	cc-by-sa-4.0
Ca absis central de sant climent de taull sonia.ogg	Àudio de l'article Absis central de Sant Climent de Taüll locutat per Sònia Vall.	cc-by-sa-4.0
Ca natura medol.ogg	Àudio de l'article Natura locutat per Medol.	cc-by-sa-4.0
Ca ramon llull alba.ogg	Àudio de l'article Ramon Llull locutat per Alba Sabaté.	cc-by-sa-4.0
Ca treva de nadal julia.ogg	Àudio de l'article Treva de Nadal locutat per Júlia.	cc-by-sa-4.0
La Represa - Ràdio Godella - 06-12-2019.mp3	Entrevista 119 de La Represa, amb Lorenzo Macías, Loren D.	CC-BY-SA 4.0
Loren D - voice.mp3	Voice Intro project de Loren D	CC-BY-SA 4.0
Daniela Lacave - voice.mp3	Autopresentació de la idol de K-pop Daniela Lacave, realitzada al programa de ràdio La Represa	CC-BY-SA 4.0
Yasmina Drissi Sales - ca.ogg	Yasmina Drissi i Sales - veu pel viquiprojecte La veu és lliure	cc-by-sa-4.0
Cesk Freixas - ca.ogg	[[:ca:Cesk Freixas|Cesk Freixas]] - veu pel viquiprojecte La veu és lliure	cc-by-sa-4.0
Adrià Carrasco i Tarrés - veu.ogg	Veu d'Adrià Carrasco i Tarrés, activista i tècnic de so català	cc-by-sa-4.0
Silvia Cebolla - voice.mp3	Autopresentació de la comunicadora aragonesa Silvia Cebolla	cc-by-sa 4.0
La Represa - Ràdio Godella - 22-11-2019.mp3	Entrevista amb la comunicadora aragonesa Silvia Cebolla	cc-by-sa 4.0
La Represa - Ràdio Godella - 06-03-2020.mp3	Entrevista a Daniela Lacave, Nia, artista de KPOP a UnionWave.	cc-by-sa-4.0
Ferran Martínez - voice.mp3	Mostra de veu de Ferran Martínez Ruiz	cc-by-sa-4.0
Antonio Laguna - voice.mp3	Voice intro project d'Antonio Laguna	cc-by-sa-4.0
El Virgo de Vicenteta - La Maredeueta - Toni de l'Hostal.mp3	Toni de l'Hostal interpreta la seua versió de "La Maredeueta".	cc-by-sa-4.0
Juli Mira - voice.mp3	Autopresentació de l'artista Juli Mira	cc-by-sa 4.0
Francesc Fenollosa - Capità Planeta.mp3	Veu amb la catchphrase del Capità Planeta	cc-by-sa-4.0
A Hare Grows in Manhattan - Edu Borja.mp3	Extracte del text de Bugs Bunny al curtmetratge "A Hare Grows in Manhattan", amb veu d'Edu Borja	cc-by-sa-4.0
What's up Doc - Edu Borja.mp3	Catchphrase de Bugs Bunny realitzada per Edu Borja	cc-by-sa-4.0
Merrie Melodies outro - Edu Borja.mp3	Outro de Merrie Melodies cantada per Edu Borja	cc-by-sa-4.0
Vito Corleone - Juli Mira.mp3	Representació de Vito Corleone realitzada per Juli Mira el 2020.	cc-by-sa-4.0
Mr Satan - 176.mp3	Veu de Mr. Satan (Sergio Capelo) a l'episodi 176 de Bola de Drac Z	CC-BY-SA 4.0
Mr Satan - 213.mp3	Veu de Mr. Satan (Sergio Capelo) a l'episodi 213 de Bola de Drac Z	CC-BY-SA 4.0
Karate Kid - pel·lícula.mp3	Veu de Juli Mira fent de Mestre Miyagi a la pel·lícula "Karate Kid"	CC-BY-SA 4.0
El Padrí - pel·lícula.mp3	Veu de Juli Mira fent de Vito Corleone a la pel·lícula "El Padrí"	CC-BY-SA 4.0
Tortugues Mutants - April O'Neil - 002.mp3	Veu d'April O'Neil (Xus Romero) al segon episodi de la sèrie de les Tortugues Mutants	CC-BY-SA 4.0
Shin Chan - 209.mp3	Veus de Hiroshi (Rafa Contreras) i Shinnosuke Nohara (Júlia Sorlí) a l'epidosi 209 de la sèrie Shin Chan	CC-BY-SA 4.0
Shin Chan - 234.mp3	Veus de Hiroshi (Rafa Contreras) i Shinnosuke Nohara (Júlia Sorlí) a l'episodi 234 de la sèrie Shin Chan.	CC-BY-SA 4.0
Francesc Fenollosa - voice.mp3	Voice Intro Project de Francesc Fenollosa i Ten, extret de La Represa.	CC-BY-SA 4.0
La Represa - Ràdio Godella - 23-09-2016.mp3	Entrevista amb Francesc Fenollosa Ten	CC-BY-SA 4.0
Mari Carme Giner - voice.mp3	Voice Intro Project de Mari Carme Giner	CC-BY-SA 4.0
La Represa - Ràdio Godella - 8-7-2016.mp3	Entrevista amb Mari Carme i Vanessa Giner.	CC-BY-SA 4.0
Rafa Contreras - voice.mp3	Voice Intro Project de Rafa Contreras	CC-BY-SA 4.0
La Represa - Ràdio Godella - 9-12-2016.mp3	Entrevista amb Rafael Contreras Raya	CC-BY-SA 4.0
Enric Tàrrega - voice.mp3	Voice Intro Project d'Enric Tàrrega	CC-BY-SA 4.0
Viquillibre Dones en STEM - Margarita Salas.mp3	gravació d'audio del Viquillibre Dones en STEM Margarita Salas	cc-by-sa-4.0
La Represa - Ràdio Godella - 09-10-2020.mp3	Emissió pòstuma de l'entrevista feta a Enric Tàrrega i Andrés l'estiu del 2018 [https://www.tresdeu.com/2020/10/la-represa-enric-tarrega/]	cc-by-sa-4.0
Geni Tortuga - voice.mp3	Veu de Francesc Fenollosa interpretant al Geni Tortuga	CC-BY-SA 4.0
Krilin - voice.mp3	Veu de Krilin interpetada per Xus Romero.	cc-by-sa-4.0
Krilin - La Tarara (curt).mp3	Xus Romero catnta "La Tarara", amb l'adaptació feta per a Bola de Drac.	cc-by-sa-4.0
Son Goku menut - voice.mp3	Mari Carme Giner fent la veu de Goku	cc-by-sa-4.0
Miss Tagless - voice.mp3	Voice Intro project de Miss Tagless	cc-by-sa-4.0
La Represa - Ràdio Godella - 23-10-2020.mp3	Entrevista amb Miss Tagless	cc-by-sa-4.0
Vicent Garcia Devís - voice.mp3	Voice Intro project de Vicent Garcia Devís	cc-by-sa-4.0
La Represa - Ràdio Godella - 30-10-2020.mp3	Entrevista amb Vicent Garcia Devís emesa per La Represa l'octubre del 2020.	cc-by-sa-4.0
Joan Rafel Ramos - voice.mp3	Presentació en audio de Joan Rafel Ramos	cc-by-sa-4.0
Fitxer Font Àudio del 1 Com crear una referència a la Viquipèdia amb l editor gràfic.ogg	Fitxer font de l'àudio del fitxer Fitxer Font Vídeo del Com crear una referència a la Viquipèdia amb l editor gràfic	cc-by-sa-4.0
Fitxer Font Àudio 2 PujarAlCommons.ogg	Fitxer Font Àudio 2 PujarAlCommons	cc-by-sa-4.0
Fitxer Font Àudio 3 Canvi De Nom Pàgina de la Viquipèdia.ogg	Fitxer Font Àudio 3 Canvi De Nom Pàgina de la Viquipèdia	cc-by-sa-4.0
